token	transliteration	segmentation	root
абсолютно	absolyutno	absolyut n o	absolyut
абстрактного	abstraktnogo	abstrakt n ogo	abstrakt
авиакомпания	aviakompaniya	avia kompani ya	kompani
авиации	aviatsii	avi atsi i	avi
авиационному	aviatsionnomu	avi atsi onn omu	avi
Австрии	Avstrii	Avstri i	Avstri
австрийских	avstriyskih	avstriy sk ih	avstriy
Австрийской	Avstriyskoy	Avstriy sk oy	Avstriy
австрийском	avstriyskom	avstriy sk om	avstriy
автобуса	avtobusa	avto bus a	bus
автобусов	avtobusov	avto bus ov	bus
автовозов	avtovozov	avto voz ov	voz
автомобили	avtomobili	avto mobil i	mobil
автомобилисты	avtomobilisty	avto mobil ist y	mobil
автомобиля	avtomobilya	avto mobil ya	mobil
автор	avtor	avtor	avtor
агентство	agentstvo	agent stv o	agent
Агентство	Agentstvo	Agent stv o	Agent
Азовском	Azovskom	Azov sk om	Azov
академии	akademii	akademi i	akademi
академик	akademik	akadem ik	akadem
аккумулировав	akkumulirovav	akkumul ir ova v	akkumul
активнее	aktivneye	aktiv n eye	aktiv
активности	aktivnosti	aktiv n ost i	aktiv
актуальность	aktual'nost'	aktual'n ost'	aktual'n
алтайские	altayskiye	altay sk iye	altay
Алтайском	Altayskom	Altay sk om	Altay
альпийского	al'piyskogo	al'p iy sk ogo	al'p
американские	amerikanskiye	amerik an sk iye	amerik
американских	amerikanskih	amerik an sk ih	amerik
амплитуды	amplitudy	amplitud y	amplitud
аналогом	analogom	analog om	analog
Анкаре	Ankare	Ankar e	Ankar
аномальные	anomal'nyye	anomal' n yye	anomal
антибиотикам	antibiotikam	anti bio t ik am	bio
атаках	atakah	atak ah	atak
атлантический	atlanticheskiy	atlanti<ch> esk iy	atlanti<ch>
аэропорт	aeroport	aer o port	aer
байкеров	baykerov	bay k er ov	port
балов	balov	bal ov	bay
Бам	Bam	Bam	bal
банка	banka	bank a	bank
баррельные	barrel'nyye	barrel' n yye	barrel
бассейн	basseyn	basseyn	basseyn
бассейна	basseyna	basseyn a	basseyn
бассейнах	basseynah	basseyn ah	basseyn
бассейне	basseyne	basseyn e	basseyn
башен	bashen	bashen	bashen
Башкирии	Bashkirii	Bashkir i i	Bashkir
бежали	bezhali	be<zh> a l i	be<zh>
беженец	bezhenets	bezh en ets	bezh
Беженцы	Bezhentsy	Bezh en ts y	Bezh
безопасном	bezopasnom	bez opas n om	opas
безостановочное	bezostanovochnoye	bez ostanov och n oye	ostanov
Белграде	Belgrade	Belgrad e	Belgrad
берега	berega	bereg a	bereg
берегов	beregov	bereg ov	bereg
береговой	beregovoy	bereg ov oy	bereg
Берлине	Berline	Berlin e	Berlin
бесплатная	besplatnaya	bes plat n aya	plat
Беспричинные	Besprichinnyye	Bes prichin n yye	prichin
ближайших	blizhayshih	bli<zh> aysh ih	bli<zh>
близкой	blizkoy	blizk oy	blizk
блокирующая	blokiruyuschaya	blok ir u yusch aya	blok
болевшие	bolevshiye	bol evsh iye	bol
более	boleye	bol eye	bol
болеет	boleyet	bol e yet	bol
болезни	bolezni	bolezn i	bolezn
болезнью	bolezn'yu	bolezn' yu	bolezn'
больнице	bol'nitse	bol' nits e	bol'
больницы	bol'nitsy	bol' nits y	bol'
больничных	bol'nichnyh	bol' ni<ch> n yh	bol'
больными	bol'nymi	bol' n ymi	bol'
Большая	Bol'shaya	Bol'sh aya	Bol'sh
больше	bol'she	bol'sh e	bol'sh
большее	bol'sheye	bol'sh eye	bol'sh
большим	bol'shim	bol'sh im	bol'sh
большинстве	bol'shinstve	bol'sh in stv e	bol'sh
большой	bol'shoy	bol'sh oy	bol'sh
бомбы	bomby	bomb y	bomb
боролись	borolis'	bor o l i s'	bor
бороться	borot'sya	bor o t' sya	bor
боялись	boyalis'	bo ya l i s'	bo
бросился	brosilsya	bros i l sya	bros
брюшной	bryushnoy	bryu<sh> n oy	bryu<sh>
будто	budto	budto	budto
буйством	buystvom	buy stv om	buy
бушевавших	bushevavshih	bush eva vsh ih	bush
бывает	byvayet	by va yet	by
бывшей	byvshey	by vsh ey	by
была	byla	by l a	by
было	bylo	by l o	by
быстрый	bystryy	bystr yy	bystr
быть	byt'	by t'	by
важна	vazhna	vazhn a	vazhn
вакцин	vaktsin	vaktsin	vaktsin
Вакцина	Vaktsina	Vaktsin a	Vaktsin
вакцинацию	vaktsinatsiyu	vaktsin atsi yu	vaktsin
вакцинация	vaktsinatsiya	vaktsin atsi ya	vaktsin
ванных	vannyh	van n yh	van
вблизи	vblizi	v bliz i	bliz
введения	vvedeniya	v ved en iya	ved
ввезенные	vvezennyye	v vez enn yye	vez
вдоль	vdol'	vdol'	vdol'
ведения	vedeniya	ved eni ya	ved
ведомстве	vedomstve	vedomstv e	vedomstv
ведут	vedut	ved ut	ved
ведущие	veduschiye	ved usch iye	ved
велик	velik	velik	velik
велика	velika	velik a	velik
велики	veliki	velik i	Velik
Великолукские	Velikolukskiye	Velik o luk sk iye	luk
величин	velichin	veli<ch> in	veli<ch>
величине	velichine	veli<ch> in e	veli<ch>
верили	verili	ver i l i	ver
вероятно	veroyatno	veroyat n o	veroyat
вероятность	veroyatnost'	veroyat n ost'	veroyat
вертолета	vertoleta	vert o let a	vert
вертолеты	vertolety	vert o let y	vert
верхний	verhniy	verh n iy	verh
верхних	verhnih	verh n ih	verh
вершине	vershine	ver<sh> in e	ver<sh>
Веры	Very	Ver y	Ver
веселое	veseloye	vesel oye	vesel
Весной	Vesnoy	Vesn oy	Vesn
весьма	ves'ma	ves'ma	ves'
ветеранов	veteranov	veteran ov	veteran
ветром	vetrom	vetr om	vetr
вещам	vescham	vesch am	vesch
вещами	veschami	vesch ami	vesch
веяний	veyaniy	veyan iy	veyan
взорвал	vzorval	vzo rv a l	rv
взрослые	vzroslyye	vzrosl yye	vzrosl
Взрослым	Vzroslym	Vzrosl ym	Vzrosl
взрыва	vzryva	vz ryv a	ryv
взрывного	vzryvnogo	vz ryv n ogo	ryv
взрывов	vzryvov	vz ryv ov	ryv
взял	vzyal	vzya l	vzya
взятия	vzyatiya	vzya ti ya	vzya
вид	vid	vid	vid
видел	videl	vid e l	vid
видели	videli	vid e l i	vid
видимом	vidimom	vid im om	vid
видно	vidno	vid n o	vid
видов	vidov	vid ov	vid
виду	vidu	vid u	vid
виновника	vinovnika	vin ov nik a	vin
вирусной	virusnoy	virus n oy	virus
вирусы	virusy	virus y	virus
включает	vklyuchayet	v klyuch a yet	klyuch
влагой	vlagoy	vlag oy	vlag
властей	vlastey	vlast ey	vlast
Власти	Vlasti	Vlast i	Vlast
влияния	vliyaniya	vliya ni ya	vliya
Вначале	Vnachale	V na cha l e	cha
вниз	vniz	vniz	vnim
внимание	vnimaniye	vnim a ni ye	vnim
внимания	vnimaniya	vnim a ni ya	vod
воде	vode	vod e	vod
водителями	voditelyami	vod i tel yami	vod
водоснабжением	vodosnabzheniyem	vod o snabzh eni yem	snabzh
водохранилищ	vodohranilisch	vod o hran i l isch	vod hran
водяным	vodyanym	vod yan ym	vod
военкоматах	voyenkomatah	voyen kom at ah	voyen kom
военное	voyennoye	voyen n oye	voyen
военным	voyennym	voyen n ym	voyen
военных	voyennyh	voyen n yh	voyen
возвращаться	vozvraschat'sya	voz vra<sch> a t' sya	vra<sch>
возвращаются	vozvraschayutsya	voz vra<sch> a yut sya	vra<sch>
воздействию	vozdeystviyu	voz dey stv i yu	dey
воздухе	vozduhe	vozduh e	vozduh
возможно	vozmozhno	voz mo<zh> n o	mo<zh>
Возможно	Vozmozhno	Voz mo<zh> n o	mo<zh>
возможном	vozmozhnom	voz mo<zh> n om	mo<zh>
возможности	vozmozhnosti	voz mo<zh> n ost i	mo<zh>
Возможность	Vozmozhnost'	Voz mo<zh> n ost'	mo<zh>
возможных	vozmozhnyh	voz mo<zh> n yh	mo<zh>
Возникновение	Vozniknoveniye	Voznik n ove ni ye	Voznik
возникновения	vozniknoveniya	voznik n ove ni ya	voznik
возникшей	voznikshey	voznik sh ey	voznik
возобновились	vozobnovilis'	voz ob nov i l i s'	nov
возобновлении	vozobnovlenii	voz ob novl eni i	novl
возрасти	vozrasti	voz rast i	rast
войны	voyny	voyn y	voyn
Волгоградской	Volgogradskoy	Volg o grad sk oy	Volg grad
Волна	Volna	Voln a	Voln
Волшебник	Volshebnik	Volsheb nik	Volsheb
вооружившись	vooruzhivshis'	vo oruzh i vsh i s'	oruzh
вопрос	vopros	vopros	vosstanov
восстановить	vosstanovit'	vosstanov i t'	Vostok
Востока	Vostoka	Vostok a	Vostok
Востоком	Vostokom	Vostok om	Vosto<ch>
Восточная	Vostochnaya	Vosto<ch> n aya	vosto<ch>
восточноафриканский	vostochnoafrikanskiy	vosto<ch> n o afrik an sk iy	afrik
восточной	vostochnoy	vosto<ch> n oy	vosto<ch>
восьми	vos'mi	vos'm i	vos'm
воюют	voyuyut	vo yu yut	vo
впервые	vpervyye	v perv yye	perv
вплоть	vplot'	v plot'	plot'
впросак	vprosak	vprosak	Vrach
Врачей	Vrachey	Vrach ey	vrem
временами	vremenami	vrem en ami	vrem
времён	vremon	vrem on	vrem
время	vremya	vrem ya	Vse
Всеукраинской	Vseukrainskoy	Vse ukrain sk oy	ukrain
вскоре	vskore	v skor e	skor
вспышках	vspyshkah	vspy<sh> k ah	vspy<sh>
вспышку	vspyshku	vspy<sh> k u	vspy<sh>
втайне	vtayne	v tay n e	tay
вторая	vtoraya	vtor aya	vtor
Вторая	Vtoraya	Vtor aya	Vtor
вторника	vtornika	vtornik a	vtornik
второе	vtoroye	vtor oye	vtor
вулкана	vulkana	vulkan a	vulkan
вулканического	vulkanicheskogo	vulkan ichesk ogo	vulkan
вулканическое	vulkanicheskoye	vulkan ichesk oye	vulkan
вулканы	vulkany	vulkan y	vulkan
входили	vhodili	v hod i l i	hod
вчера	vchera	vchera	vchera
выбрасывает	vybrasyvayet	vy bras yva yet	bras
выбросил	vybrosil	vy br<o>s i l	br<o>s
выводу	vyvodu	vy vod u	vod
выглядит	vyglyadit	vy glyad it	glyad
выглядят	vyglyadyat	vy glyad yat	glyad
выглянуло	vyglyanulo	vy glya nu l o	glya
выгодны	vygodny	vygod n y	vygod
выдавшего	vydavshego	vy da vsh ego	da
выделения	vydeleniya	vy del eni ya	del
выделить	vydelit'	vy del i t'	del
выдержала	vyderzhala	vy derzh a l a	derzh
выдержать	vyderzhat'	vy derzh a t'	derzh
выезжать	vyyezzhat'	vy ye<z><zh> a t'	ye<z><zh>
выехавшая	vyyehavshaya	vy yeh a vsh aya	yeh
выжившего	vyzhivshego	vy zhi v sh ego	zhi
вызвал	vyzval	vy zv a l	zv
вызвали	vyzvali	vy zv a l i	zv
Вызванное	Vyzvannoye	Vy zv a nn oye	zv
выздоровели	vyzdoroveli	vy zdorov e l i	zdorov
выкрики	vykriki	vy krik i	krik
вылезли	vylezli	vy lez l i	lez
вымываются	vymyvayutsya	vy my va yut sya	my
выпала	vypala	vy pa l a	pa
выпало	vypalo	vy pa l o	pa
выписаны	vypisany	vy pis a n y	pis
выполняем	vypolnyayem	vy poln ya yem	poln
выпрашивал	vyprashival	vy pra<sh> iva l	pra<sh>
выпущено	vypuscheno	vy pu<sch> en o	pu<sch>
выработка	vyrabotka	vy rabot k a	rabot
выраженной	vyrazhennoy	vyra<zh> enn oy	vyra<zh>
выразил	vyrazil	vyraz i l	vyraz
высвободилось	vysvobodilos'	vy svobod i l o s'	svobod
Высказаться	Vyskazat'sya	Vy skaz a t' sya	skaz
высоких	vysokih	vysok ih	vysok
высоко	vysoko	vysok o	vysok
высокого	vysokogo	vysok ogo	vysok
высокогорных	vysokogornyh	vysok o gor n yh	vysok gor
высота	vysota	vysot a	vysot
высотная	vysotnaya	vysot n aya	vysot
высотным	vysotnym	vysot n ym	vysot
высоту	vysotu	vysot u	vysot
высоты	vysoty	vysot y	vysot
выступила	vystupila	vy stup i l a	stup
выход	vyhod	vy hod	hod
выходном	vyhodnom	vy hod n om	hod
выше	vyshe	vy<sh> e	vy<sh>
вышли	vyshli	vy sh l i	sh
выявлен	vyyavlen	vyyav l en	vyyav
выявлено	vyyavleno	vy yav l en o	yav
выясняют	vyyasnyayut	vy yasn ya yut	yasn
Гадесом	Gadesom	Gades om	Gades
газо	gazo	gaz o	gaz
газов	gazov	gaz ov	gaz
газы	gazy	gaz y	gaz
Гвинею	Gvineyu	Gvine yu	Gvine
геноцид	genotsid	gen o tsid	gen tsid
геноцида	genotsida	gen o tsid a	gen tsid
гепатитами	gepatitami	gepat it ami	gepat
гибель	gibel'	gib el'	gib
гидрантов	gidrantov	gidr ant ov	gidr
Гималаях	Gimalayah	Gimala yah	Gimala
глава	glava	glav a	glav
главная	glavnaya	glavn aya	glavn
Главная	Glavnaya	Glavn aya	Glavn
Главного	Glavnogo	Glavn ogo	Glavn
главный	glavnyy	glavn yy	glavn
Главный	Glavnyy	Glavn yy	Glavn
глубина	glubina	glub in a	glub
глубине	glubine	glub in e	glub
глубинных	glubinnyh	glub in n yh	glub
глубоко	gluboko	glubok o	glubok
глубокое	glubokoye	glubok oye	glubok
глубокой	glubokoy	glubok oy	glubok
гнойные	gnoynyye	gn oy n yye	gn
говорится	govoritsya	govor it sya	govor
говоря	govorya	govor ya	govor
головная	golovnaya	golov n aya	golov
голод	golod	golod	golod
горные	gornyye	gor n yye	gor
горных	gornyh	gor n yh	gor
город	gorod	gorod	gorod
городке	gorodke	gorod k e	gorod
городской	gorodskoy	gorod sk oy	goro<zh>
горожан	gorozhan	goro<zh> an	goro<zh>
горожанам	gorozhanam	goro<zh> an am	goryach
горячие	goryachiye	goryach iye	Gos
Госдумы	Gosdumy	Gos dum y	dum
готовил	gotovil	gotov i l	gotov
град	grad	grad	grad
градом	gradom	grad om	grad
ГРАЖДАН	GRAZHDAN	GRAZHD AN	GRAZHD
гражданином	grazhdaninom	grazhd an in om	grazhd
гражданские	grazhdanskiye	grazhd an sk iye	grazhd
гражданской	grazhdanskoy	grazhd an sk oy	grazhd
граната	granata	granat a	granat
График	Grafik	Grafik	Grafik
Грецией	Gretsiyey	Gretsiy ey	Gretsiy
гриппа	grippa	gripp a	gripp
грозы	grozy	groz y	groz
грубейшие	grubeyshiye	grub eysh iye	grub
грузовых	gruzovyh	gruz ov yh	gruz
грузом	gruzom	gruz om	gruz
грунта	grunta	grunt a	grunt
группа	gruppa	grupp a	grupp
грядущего	gryaduschego	gryad usch ego	gryad
грязевого	gryazevogo	gryaz ev ogo	gryaz
гулять	gulyat'	gul ya t'	gul
гуманитарный	gumanitarnyy	guman itar n yy	guman
гуманитарным	gumanitarnym	guman itar n ym	guman
Да	Da	Da	Da
давненько	davnen'ko	davn en'k o	davn
Дальнейших	Dal'neyshih	Dal' n eysh ih	Dal'
Дальний	Dal'niy	Dal' n iy	Dal'
Дальше	Dal'she	Dal' she	Dal'
данного	dannogo	da nn ogo	da
данном	dannom	da nn om	da
данный	dannyy	da nn yy	da
данных	dannyh	da nn yh	da
Два	Dva	Dva	Dva
двигалось	dvigalos'	dvig a l o s'	dvig
двигателем	dvigatelem	dvig atel em	dvig
движение	dvizheniye	dvi<zh> eni ye	dvi<zh>
движения	dvizheniya	dvi<zh> eni ya	dvi<zh>
двое	dvoye	dv o ye	dv
двоих	dvoih	dv o ih	dv
двора	dvora	dvor a	dvor
двум	dvum	dv um	dv
двухмесячная	dvuhmesyachnaya	dv uh mesya<ch> n aya	dv
деды	dedy	ded y	mesya<ch>
дежурство	dezhurstvo	dezhur stv o	ded
действием	deystviyem	dey stv i yem	dezhur
декабре	dekabre	dekabr e	dey
деклассированные	deklassirovannyye	de klass ir ova nn yye	dekabr
дел	del	del	klass
денежные	denezhnyye	dene<zh> n yye	dene<zh>
день	den'	den'	den'
деньги	den'gi	den'g i	den'g
депрессии	depressii	depressi i	depressi
деревенский	derevenskiy	dereven sk iy	dereven
деревни	derevni	derevn i	derevn
деревушке	derevushke	derev ushk e	derev
деревьев	derev'yev	derev' yev	derev
держали	derzhali	derzh a l i	derzh
десяти	desyati	desyat i	desyat
десятка	desyatka	desyat k a	desyat
десятках	desyatkah	desyat k ah	desyat
десятки	desyatki	desyat k i	desyat
дети	deti	det i	det
дефицит	defitsit	defitsit	defitsit
дешевые	deshevyye	deshev yye	deshev
джоулей	dzhouley	dzhoul ey	dzhoul
диагноз	diagnoz	diagnoz	diagnoz
диапазоне	diapazone	diapazon e	diapazon
диареи	diarei	diare i	diare
Диарея	Diareya	Diare ya	Diare
диване	divane	divan e	divan
дилеры	dilery	diler y	diler
диоксида	dioksida	dioksid a	dioksid
дирекции	direktsii	direkt si i	direkt
дню	dnyu	dn yu	dn
добавил	dobavil	do bav i l	bav
добавила	dobavila	do bav i l a	bav
добровольцах	dobrovol'tsah	dobr o vol' ts ah	dobr vol'
дождевую	dozhdevuyu	dozhd ev uyu	dozhd
дождей	dozhdey	dozhd ey	dozhd
дождями	dozhdyami	dozhd yami	dozhd
документального	dokumental'nogo	dokument al'n ogo	dokument
долетел	doletel	do let e l	let
должен	dolzhen	dol<zh> en	dol<zh>
должна	dolzhna	dol<zh> n a	dol<zh>
долины	doliny	dolin y	dolin
дом	dom	dom	dom
доме	dome	dom e	dom
Доминикане	Dominikane	Dominikan e	Dominikan
доминировали	dominirovali	domin ir ova l i	domin
домом	domom	dom om	dom
Донбасса	Donbassa	Donbass a	Donbass
допустили	dopustili	do pust i l i	pust
дорогах	dorogah	dorog ah	dorog
Дороги	Dorogi	Dorog i	Dorog
дорогу	dorogu	dorog u	dorog
доставил	dostavil	dostav i l	dostav
доставлено	dostavleno	dostav l en o	dostav
достаточном	dostatochnom	dosta t och n om	dosta och
достигала	dostigala	dostig al a	dostig
достигать	dostigat'	dostig a t'	dostig
достигнут	dostignut	dostig n ut	dostig
доходила	dohodila	do hod i l a	hod
доходящие	dohodyaschiye	do hod yasch iye	hod
драка	draka	drak a	drak
другими	drugimi	drug imi	drug
других	drugih	drug ih	drug
Другой	Drugoy	Drug oy	Drug
дружественного	druzhestvennogo	dru<zh> estv enn ogo	dru<zh>
друзья	druz'ya	dru<z>' ya	dru<z>'
думать	dumat'	dum a t'	dum
Дунай	Dunay	Dunay	Dunay
Духовного	Duhovnogo	Duh ovn ogo	Duh
душевых	dushevyh	du<sh> ev yh	du<sh>
душем	dushem	du<sh> em	du<sh>
души	dushi	du<sh> i	du<sh>
евро	yevro	yevro	yevro
европейские	yevropeyskiye	yevrop ey sk iye	yevrop
Евросоюза	Yevrosoyuza	Yevr o soyuz a	Yevr soyuz
Егор	Yegor	Yegor	Yegor
еду	yedu	yed u	yed
еды	yedy	yed y	yed
ежегодно	yezhegodno	yezhe god n o	yezhe god
ежедневного	yezhednevnogo	yezhe dn evn ogo	yezhe dn
если	yesli	yesli	yesli
Есть	Yest'	Yest'	Yest'
ждем	zhdem	zhd em	zhd
ждут	zhdut	zhd ut	zhd
женщина	zhenschina	zhen schin a	zhen
жерла	zherla	zherl a	zherl
жерло	zherlo	zherl o	zherl
Жертвам	Zhertvam	Zhertv am	Zhertv
Жертвами	Zhertvami	Zhertv ami	Zhertv
жертвах	zhertvah	zhertv ah	zhertv
жертвы	zhertvy	zhertv y	zhertv
жесткие	zhestkiye	zhestk iye	zhestk
жестоких	zhestokih	zhestok ih	zhestok
жестокости	zhestokosti	zhestok ost i	zhestok
живешь	zhivesh'	zhiv esh'	zhiv
живого	zhivogo	zhiv ogo	zhiv
живущих	zhivuschih	zhiv usch ih	zhiv
жидкости	zhidkosti	zhidk ost i	zhidk
жидкость	zhidkost'	zhidk ost'	zhidk
жилого	zhilogo	zhil ogo	zhil
Жителям	Zhitelyam	Zhi tel yam	Zhi
журнала	zhurnala	zhurnal a	zhurnal
заболеваемости	zabolevayemosti	za bol e va yem ost i	bol
заболеваниями	zabolevaniyami	za bol e va ni yami	bol
заболевших	zabolevshih	za bol e vsh ih	bol
заболели	zaboleli	za bol e l i	bol
забрал	zabral	za br a l	br
завершается	zavershayetsya	za versh a yet sya	versh
зависят	zavisyat	zavis yat	zavis
завозить	zavozit'	za voz i t'	voz
заглохнуть	zaglohnut'	za gloh nu t'	gloh
загнало	zagnalo	za gn a l o	gn
загрязненного	zagryaznennogo	za gryaz n enn ogo	gryaz
загрязнёнными	zagryaznonnymi	za gryaz n onn ymi	gryaz
задавить	zadavit'	za dav i t'	dav
задействованы	zadeystvovany	za dey stv ova n y	dey
задержаться	zaderzhat'sya	za derzh a t' sya	derzh
задымления	zadymleniya	za dyml eni ya	dyml
заирский	zairskiy	zair sk iy	zair
закрытых	zakrytyh	za kry t yh	kry
залегал	zalegal	za leg a l	leg
залив	zaliv	zaliv	zaliv
заложниками	zalozhnikami	za lo<zh> nik ami	lo<zh>
замдиректора	zamdirektora	zam direk tor a	direk
замыкания	zamykaniya	za myk a ni ya	myk
занимается	zanimayetsya	za nim a yet sya	nim
заостряло	zaostryalo	za ostr ya l o	ostr
западного	zapadnogo	zapad n ogo	zapad
Западной	Zapadnoy	Zapad n oy	Zapad
западном	zapadnom	zapad n om	zapad
западные	zapadnyye	zapad n yye	zapad
западом	zapadom	zapad om	zapad
запах	zapah	zapah	plat
заплатят	zaplatyat	za plat yat	zap
запчасти	zapchasti	zap chast i	chast
заражения	zarazheniya	zara<zh> eni ya	zara<zh>
зараженными	zarazhennymi	zara<zh> enn ymi	zara<zh>
зараженных	zarazhennyh	zara<zh> enn yh	zara<zh>
заражены	zarazheny	zara<zh> en y	zara<zh>
заразились	zarazilis'	zaraz i l i s'	zaraz
зарубежных	zarubezhnyh	za rube<zh> n yh	rube<zh>
зарубежья	zarubezh'ya	za rube<zh>' ya	rube<zh>'
заснеженных	zasnezhennyh	za sne<zh> enn yh	sne<zh>
застрявшими	zastryavshimi	zastr ya vsh imi	zastr
засух	zasuh	za suh	suh
засуха	zasuha	za suh a	suh
затопили	zatopili	za top i l i	top
затопленных	zatoplennyh	za topl enn yh	topl
Затоплено	Zatopleno	Za topl en o	topl
затоплены	zatopleny	za topl en y	topl
затраты	zatraty	za trat y	trat
зафиксировали	zafiksirovali	za fiks ir ova l i	fiks
зачем	zachem	zachem	zachem
защитит	zaschitit	zaschit it	zaschit
защитные	zaschitnyye	zaschit n yye	zaschit
защищены	zaschischeny	zaschi<sch> en y	zaschi<sch>
заявил	zayavil	zayav i l	zayav
заявило	zayavilo	zayav i l o	zayav
звуковой	zvukovoy	zvuk ov oy	zvuk
здесь	zdes'	zdes'	zdes'
здравоохранение	zdravoohraneniye	zdrav o o hran eni ye	zdrav hran
здравоохранению	zdravoohraneniyu	zdrav o o hran eni yu	zdrav hran
Зейское	Zeyskoye	Zeysk oye	Zeysk
земель	zemel'	zemel'	zemel'
Земле	Zemle	Zeml e	Zeml
землетресений	zemletreseniy	zeml e tres eni y	zeml tres
земли	zemli	zeml i	zeml
Земли	Zemli	Zeml i	Zeml
зим	zim	zim	zim
зима	zima	zim a	zim
зимой	zimoy	zim oy	zim
знак	znak	znak	znak
знаменитого	znamenitogo	znamenit ogo	znamenit
знать	znat'	zna t'	zna
значительный	znachitel'nyy	zna<ch> i tel'n yy	zna<ch>
золота	zolota	zolot a	zolot
зона	zona	zon a	zon
зоне	zone	zon e	zon
зорко	zorko	zork o	zork
игнорирует	ignoriruyet	ignor ir u yet	ignor
идет	idet	id et	id
идёт	idot	id ot	id
извергается	izvergayetsya	izverg a yet sya	izverg
извержение	izverzheniye	izver<zh> eni ye	izver<zh>
извержения	izverzheniya	izver<zh> eni ya	izver<zh>
известия	izvestiya	iz vest i ya	vest
Известно	Izvestno	Iz vest n o	vest
извинить	izvinit'	iz vin i t'	vin
изначально	iznachal'no	iz na cha l' n o	cha
изобретатели	izobretateli	izobret a tel i	izobret
израильтянах	izrail'tyanah	izrail' t yan ah	izrail'
Израиля	Izrailya	Izrail ya	Izrail
изучением	izucheniyem	iz uch eni yem	uch
имевший	imevshiy	ime vsh iy	ime
имеет	imeyet	ime yet	ime
Имеется	Imeyetsya	Ime yet sya	Ime
имела	imela	ime l a	ime
имена	imena	im en a	im
имени	imeni	im en i	im
имеют	imeyut	ime yut	ime
имеющий	imeyuschiy	ime yusch iy	ime
имеющим	imeyuschim	ime yusch im	ime
имеющими	imeyuschimi	ime yusch imi	ime
имеющих	imeyuschih	ime yusch ih	ime
иммунизацию	immunizatsiyu	immun iz atsi yu	immun
иная	inaya	in aya	in
ингушских	ingushskih	ingush sk ih	ingush
Индией	Indiyey	Indi yey	Indi
Индии	Indii	Indi i	Indi
Индийские	Indiyskiye	Indiy sk iye	Indiy
индийского	indiyskogo	indiy sk ogo	indiy
Индия	Indiya	Indi ya	Indi
иномарки	inomarki	in o mark i	in mark
интенсивность	intensivnost'	intens iv n ost'	intens
интенсивными	intensivnymi	intens iv n ymi	intens
инфекционные	infektsionnyye	infektsi onn yye	infektsi
инфекционных	infektsionnyh	infektsi onn yh	infektsi
инфицированными	infitsirovannymi	infits ir ova nn ymi	infits
инфографику	infografiku	info grafik u	info grafik
инфогруппы	infogruppy	info grupp y	info grupp
информации	informatsii	inform atsi i	inform
Информации	Informatsii	Inform atsi i	Inform
инфраструктурных	infrastrukturnyh	infra struktur n yh	struktur
инъекции	in"yektsii	in"yek tsi i	yek
иранского	iranskogo	iran sk ogo	iran
иранской	iranskoy	iran sk oy	iran
исключено	isklyucheno	isklyuch en o	isklyuch
искренне	iskrenne	iskrenn e	iskrenn
исламским	islamskim	islam sk im	islam
Исламское	Islamskoye	Islam sk oye	Islam
Испанию	Ispaniyu	Ispan i yu	Ispan
Использование	Ispol'zovaniye	Is pol'z ova ni ye	pol'z
использовании	ispol'zovanii	is pol'z ova ni i	pol'z
использования	ispol'zovaniya	is pol'z ova ni ya	pol'z
испугался	ispugalsya	is pug a l sya	pug
испытаниям	ispytaniyam	ispyt a ni yam	ispyt
Исследование	Issledovaniye	Issledova ni ye	Issledova
исследования	issledovaniya	issledova ni ya	issledova
истинные	istinnyye	istin n yye	istin
история	istoriya	istori ya	istori
источника	istochnika	istochnik a	istochnik
источникам	istochnikam	istochnik am	istochnik
источниках	istochnikah	istochnik ah	istochnik
исход	ishod	ishod	ishod
Йемене	Yyemene	Yyemen e	Yyemen
кавказцы	kavkaztsy	kavkazts y	kavkazts
кадры	kadry	kadr y	kadr
каждому	kazhdomu	kazhd omu	kazhd
каждый	kazhdyy	kazhd yy	kazhd
каждых	kazhdyh	kazhd yh	kazhd
Казахстана	Kazahstana	Kazahstan a	Kazahstan
Казахстане	Kazahstane	Kazahstan e	Kazahstan
Как	Kak	Kak	Kak
какие	kakiye	kak iye	kak
Какие	Kakiye	Kak iye	Kak
календарем	kalendarem	kalendar em	kalendar
Калифорнии	Kalifornii	Kaliforn i i	Kaliforn
камеры	kamery	kamer y	kamer
Камчатке	Kamchatke	Kamchatk e	Kamchatk
канадские	kanadskiye	kanad sk iye	kanad
каникулы	kanikuly	kanikul y	kanikul
капитана	kapitana	kapitan a	kapitan
капризов	kaprizov	kapriz ov	kapriz
картошкой	kartoshkoy	kartoshk oy	kartoshk
карту	kartu	kart u	kart
Касательно	Kasatel'no	Kas a tel'n o	Kas
катаклизма	kataklizma	katakl izm a	katakl
катастрофе	katastrofe	katastrof e	katastrof
катастрофичный	katastrofichnyy	katastrof ichn yy	katastrof
катастрофичным	katastrofichnym	katastrof ichn ym	katastrof
катастрофы	katastrofy	katastrof y	katastrof
категории	kategorii	kategor ii	kategor
качество	kachestvo	kachestv o	kachestv
километрах	kilometrah	kilo metr ah	kilo metr
километре	kilometre	kilo metr e	kilo metr
километры	kilometry	kilo metr y	kilo metr
кипит	kipit	kip it	kip
классификации	klassifikatsii	klass ifik atsi i	klass
классу	klassu	klass u	klass
клеток	kletok	klet ok	klet
климата	klimata	klimat a	klimat
клинический	klinicheskiy	klinich esk iy	klinich
ковшом	kovshom	kovsh om	kovsh
количеством	kolichestvom	kolichestv om	kolichestv
коллапсу	kollapsu	kollaps u	kollaps
коллектива	kollektiva	kollektiv a	kollektiv
коллективе	kollektive	kollektiv e	kollektiv
коллекторы	kollektory	kollektor y	kollektor
команда	komanda	komand a	komand
Командование	Komandovaniye	Komand ova ni ye	Komand
Комиссии	Komissii	Komissi i	Komissi
комитет	komitet	komitet	komitet
коммуналке	kommunalke	kommunal k e	kommunal
конкурентов	konkurentov	konkurent ov	konkurent
констатировать	konstatirovat'	konstat irov at'	konstat
конструкций	konstruktsiy	konstruk ts iy	konstruk
контактировал	kontaktiroval	kontakt irov al	kontakt
контактных	kontaktnyh	kontakt n yh	kontakt
Контактных	Kontaktnyh	Kontakt n yh	Kontakt
континент	kontinent	kontinent	kontinent
континента	kontinenta	kontinent a	kontinent
континентальный	kontinental'nyy	kontinent al'n yy	kontinent
конторе	kontore	kontor e	kontor
контролем	kontrolem	kontrol em	kontrol
концентрации	kontsentratsii	kontsentr atsi i	kontsentr
концерном	kontsernom	kontsern om	kontsern
Координаты	Koordinaty	Koordinat y	Koordinat
копейки	kopeyki	kopeyk i	kopeyk
копия	kopiya	kopi ya	kopi
кораллам	korallam	korall am	korall
коренного	korennogo	koren n ogo	koren
короткие	korotkiye	korotk iye	korotk
корреспонденту	korrespondentu	korrespond ent u	korrespond
кортедж	kortedzh	kortedzh	kortedzh
корью	kor'yu	kor' yu	kor'
косвенно	kosvenno	kosvenn o	kosvenn
космоса	kosmosa	kosmos a	kosmos
коснуться	kosnut'sya	kos nu t' sya	kos
которую	kotoruyu	kotor uyu	kotor
которых	kotoryh	kotor yh	kotor
край	kray	kray	kray
крайности	kraynosti	krayn ost i	krayn
краски	kraski	krask i	krask
Краснодарский	Krasnodarskiy	Krasn o dar sk iy	Krasn dar
Красноярске	Krasnoyarske	Krasn o yar sk e	Krasn yar
Красноярской	Krasnoyarskoy	Krasn o yar sk oy	Krasn yar
краткое	kratkoye	kratk oye	kratk
Кремля	Kremlya	Kreml ya	Kreml
крепость	krepost'	krepost'	krepost'
кризисном	krizisnom	krizis n om	krizis
криминальным	kriminal'nym	kriminal' n ym	kriminal'
кров	krov	krov	krov
крова	krova	krov a	krov
крови	krovi	krov i	krov
кровотечений	krovotecheniy	krov o te<ch> eni y	krov te<ch>
круг	krug	krug	krug
крупные	krupnyye	krupn yye	krupn
крупных	krupnyh	krupn yh	krupn
ксенофобия	ksenofobiya	kseno fob i ya	kseno fob
Курильском	Kuril'skom	Kuril' sk om	Kuril'
курорте	kurorte	kurort e	kurort
курортов	kurortov	kurort ov	kurort
курсантами	kursantami	kurs ant ami	kurs
курсантов	kursantov	kurs ant ov	kurs
курсантские	kursantskiye	kurs ant sk iye	kurs
кухню	kuhnyu	kuhn yu	kuhn
Кыргызстана	Kyrgyzstana	Kyrgyzstan a	Kyrgyzstan
лабораторий	laboratoriy	labor atori y	labor
Лабораторное	Laboratornoye	Labor ator n oye	Labor
Лава	Lava	Lav a	Lav
лавин	lavin	lavin	lavin
лагеря	lagerya	lager ya	lager
лазарете	lazarete	lazaret e	lazaret
легенде	legende	legend e	legend
лед	led	led	led
Ледник	Lednik	Led nik	Led
леднике	lednike	led nik e	led
ледниковый	lednikovyy	led nik ov yy	led
лезли	lezli	lez l i	lez
лекарства	lekarstva	lek ar stv a	lek
лекарство	lekarstvo	lek ar stv o	lek
лесные	lesnyye	les n yye	les
летних	letnih	letn ih	letn
лето	leto	let o	let
летом	letom	let om	let
летучая	letuchaya	let uch aya	let
лечат	lechat	lech at	lech
лечения	lecheniya	lech eni ya	lech
лечить	lechit'	lech i t'	lech
ливень	liven'	liven'	liven'
ливневыми	livnevymi	livn ev ymi	livn
ливня	livnya	livn ya	livn
ликвидировать	likvidirovat'	likvid ir ova t'	likvid
ликвидируют	likvidiruyut	likvid ir u yut	likvid
линий	liniy	lin iy	lin
лихорадка	lihoradka	lihorad k a	lihorad
лихорадкой	lihoradkoy	lihorad k oy	lihorad
личность	lichnost'	li<ch> n ost'	li<ch>
лишившимся	lishivshimsya	lish i vsh im sya	lish
лишнюю	lishnyuyu	lishn yuyu	lishn
Луксора	Luksora	Luksor a	Luksor
люди	lyudi	lyud i	lyud
людьми	lyud'mi	lyud' mi	lyud'
людях	lyudyah	lyud yah	lyud
магнитудой	magnitudoy	magnitud oy	magnitud
максимальная	maksimal'naya	maksim al'n aya	maksim
максимальном	maksimal'nom	maksim al'n om	maksim
максимальный	maksimal'nyy	maksim al'n yy	maksim
маленькие	malen'kiye	mal en'k iye	mal
маловероятно	maloveroyatno	mal o veroyatn o	mal veroyatn
Малому	Malomu	Mal omu	Mal
малоподвижным	malopodvizhnym	mal o po dvi<zh> n ym	mal dvi<zh>
Малый	Malyy	Mal yy	Mal
малыши	malyshi	mal ysh i	mal
мальчика	mal'chika	mal'chik a	mal'chik
малярию	malyariyu	malyari yu	malyari
Мариупольские	Mariupol'skiye	Mariupol' sk iye	Mariupol'
маски	maski	mask i	mask
массами	massami	mass ami	mass
массовой	massovoy	mass ov oy	mass
массовыми	massovymi	mass ov ymi	mass
материала	materiala	material a	material
машинки	mashinki	mashin k i	mashin
машину	mashinu	mashin u	mashin
медикаменты	medikamenty	medikament y	medikament
медики	mediki	medik i	medik
медицинских	meditsinskih	meditsin sk ih	meditsin
медицинское	meditsinskoye	meditsin sk oye	meditsin
медицинскую	meditsinskuyu	meditsin sk uyu	meditsin
международным	mezhdunarodnym	mezhdu narod n ym	mezhdu
мелкие	melkiye	melk iye	melk
Мелкие	Melkiye	Melk iye	Melk
мелкого	melkogo	melk ogo	melk
Мемориалу	Memorialu	Memorial u	Memorial
меньшую	men'shuyu	men'sh uyu	men'sh
меняли	menyali	men ya l i	men
мест	mest	mest	mest
места	mesta	mest a	mest
местами	mestami	mest ami	mest
месте	meste	mest e	mest
местное	mestnoye	mest n oye	mest
местные	mestnyye	mest n yye	mest
местным	mestnym	mest n ym	mest
местных	mestnyh	mest n yh	mest
Место	Mesto	Mest o	Mest
местом	mestom	mest om	mest
месяца	mesyatsa	mesyats a	mesyats
месяцев	mesyatsev	mesyats ev	mesyats
Метель	Metel'	Metel'	Metel'
метеорологической	meteorologicheskoy	meteor o log ichesk oy	meteor log
метро	metro	metro	metro
метров	metrov	metr ov	metr
мечети	mecheti	mechet i	mechet
мигалками	migalkami	mig a l k ami	mig
микроавтобусов	mikroavtobusov	mikro avto bus ov	bus
милях	milyah	mil yah	mil
минерал	mineral	mineral	mineral
минералами	mineralami	mineral ami	mineral
минеральная	mineral'naya	mineral' n aya	mineral'
минеральной	mineral'noy	mineral' n oy	mineral'
минимум	minimum	minimum	minimum
Министерства	Ministerstva	Minister stv a	Minister
минсельхозпрод	minsel'hozprod	min sel' hoz prod	min sel' hoz prod
Минску	Minsku	Minsk u	Minsk
мирно	mirno	mirn o	mirn
мнению	mneniyu	mneni yu	mneni
Многих	Mnogih	Mnog ih	Mnog
много	mnogo	mnog o	mnog
многолетние	mnogoletniye	mnog o let n iye	mnog let
многочисленные	mnogochislennyye	mnogo chisl enn yye	mnogo chisl
множество	mnozhestvo	mno<zh> estv o	mno<zh>
мобильную	mobil'nuyu	mobil' n uyu	mobil'
мобильный	mobil'nyy	mobil' n yy	mobil'
могла	mogla	mog l a	mog
могут	mogut	mog ut	mog
моделирование	modelirovaniye	model ir ova ni ye	model
моей	moyey	mo yey	mo
можно	mozhno	mo<zh> n o	mo<zh>
мозайка	mozayka	moza yk a	moza
молдаван	moldavan	moldav an	moldav
молитвы	molitvy	molitv y	molitv
молниями	molniyami	molni yami	molni
молчать	molchat'	molch a t'	molch
молятся	molyatsya	mol yat sya	mol
момент	moment	moment	moment
момента	momenta	moment a	moment
монтаж	montazh	montazh	montazh
морем	morem	mor em	mor
моря	morya	mor ya	mor
Москвы	Moskvy	Moskv y	Moskv
Московской	Moskovskoy	Moskov sk oy	Moskov
мощная	moschnaya	mo<sch> n aya	mo<sch>
мощнейшим	moschneyshim	mo<sch> neysh im	mo<sch>
мощного	moschnogo	mo<sch> n ogo	mo<sch>
мощной	moschnoy	mo<sch> n oy	mo<sch>
мощности	moschnosti	mo<sch> n ost i	mo<sch>
мощность	moschnost'	mo<sch> n ost'	mo<sch>
мощным	moschnym	mo<sch> n ym	mo<sch>
мощных	moschnyh	mo<sch> n yh	mo<sch>
мощь	mosch'	mo<sch'>	mo<sch'>
моют	moyut	mo yut	mo
Мужчина	Muzhchina	Muzh chin a	Muzh
мужчину	muzhchinu	muzh chin u	muzh
Мурманске	Murmanske	Murmansk e	Murmansk
муссонные	mussonnyye	musson n yye	musson
муссонный	mussonnyy	musson n yy	musson
мысли	mysli	mysl i	mysl
наблюдается	nablyudayetsya	nablyud a yet sya	nablyud
наблюдали	nablyudali	nablyud a l i	nablyud
наблюдений	nablyudeniy	nablyud en iy	nablyud
наблюдения	nablyudeniya	nablyud eni ya	nablyud
набор	nabor	nabor	nabor
наводнением	navodneniyem	na vod n eni yem	vod
надвигается	nadvigayetsya	na dvig a yet sya	dvig
назад	nazad	nazad	nazad
назвали	nazvali	na zv a l i	zv
Названы	Nazvany	Na zv a n y	zv
назвать	nazvat'	na zv a t'	zv
назначения	naznacheniya	naznach eni ya	naznach
называют	nazyvayut	na zyv a yut	zyv
наиболее	naiboleye	nai bol eye	bol
Наибольшему	Naibol'shemu	Nai bol' sh emu	bol'
накрыла	nakryla	na kry l a	kry
налетела	naletela	na let e l a	let
наличия	nalichiya	nalich i ya	nalich
нападения	napadeniya	napad eni ya	napad
наплывом	naplyvom	na ply v om	ply
напомнил	napomnil	na pomn i l	pomn
направила	napravila	naprav i l a	naprav
направлении	napravlenii	napravl eni i	napravl
направлению	napravleniyu	napravl eni yu	napravl
направления	napravleniya	napravl eni ya	napravl
Народ	Narod	Narod	Narod
народов	narodov	narod ov	narod
нарушено	narusheno	na rush en o	rush
нарушены	narusheny	na rush en y	rush
наряды	naryady	naryad y	naryad
насекомого	nasekomogo	nasekom ogo	nasekom
населению	naseleniyu	na sel eni yu	sel
населения	naseleniya	na sel eni ya	sel
населенные	naselennyye	na sel enn yye	sel
населенных	naselennyh	na sel enn yh	sel
насколько	naskol'ko	na skol'k o	skol'k
настолько	nastol'ko	na stol'k o	stol'k
настоящее	nastoyascheye	nastoyasch eye	nastoyasch
научились 	nauchilis'	na uch i l i s'	uch
находились	nahodilis'	nahod i l i s'	nahod
находится	nahoditsya	nahod it sya	nahod
национальному	natsional'nomu	natsi on al'n omu	natsi
национальные	natsional'nyye	natsi on al'n yye	natsi
национальный	natsional'nyy	natsi on al'n yy	natsi
нациста	natsista	nats ist a	nats
началось	nachalos'	na cha l o s'	cha
начальники	nachal'niki	nachal' nik i	nachal'
начато	nachato	na cha t o	cha
начинающий	nachinayuschiy	na chin a yusch iy	chin
начиная	nachinaya	na chin a ya	chin
нашем	nashem	nash em	nash
нашли	nashli	nash l i	nash
неба	neba	neb a	neb
небе	nebe	neb e	neb
неблагополучными	neblagopoluchnymi	ne blagopoluch n ymi	blagopoluch
Небольшие	Nebol'shiye	Ne bol'sh iye	bol'sh
небольшой	nebol'shoy	ne bol'sh oy	bol'sh
Неве	Neve	Nev e	Nev
недавнего	nedavnego	ne davn ego	davn
неделе	nedele	nedel e	nedel
недель	nedel'	nedel'	nedel'
неделю	nedelyu	nedel yu	nedel
недомогает	nedomogayet	nedomog a yet	nedomog
неестественном	neyestestvennom	ne yestestv enn om	yestestv
незабываемое	nezabyvayemoye	ne zaby va yem oye	zaby
независимых	nezavisimyh	ne zavis im yh	zavis
незначительные	neznachitel'nyye	ne zna<ch> i tel'n yye	zna<ch>
неизвестного	neizvestnogo	ne izvestn ogo	izvestn
некоторые	nekotoryye	ne kotor yye	kotor
некоторым	nekotorym	ne kotor ym	kotor
немедленной	nemedlennoy	ne medl enn oy	medl
Немецкие	Nemetskiye	Nem ets k iye	Nem
немного	nemnogo	ne mnog o	mnog
необходимо	neobhodimo	neobhodim o	neobhodim
необходимости	neobhodimosti	neobhodim ost i	neobhodim
необходимых	neobhodimyh	neobhodim yh	neobhodim
необычным	neobychnym	ne obychn ym	obychn
неоднократно	neodnokratno	ne odn o krat n o	odn krat
неохотно	neohotno	ne o hot n o	hot
Непогода	Nepogoda	Ne pogod a	pogod
непогоды	nepogody	ne pogod y	pogod
неподалеку	nepodaleku	ne po dalek u	dalek
непосредственно	neposredstvenno	ne posredstvenn o	posredstvenn
непосредственное	neposredstvennoye	ne posredstvenn oye	posredstvenn
непредсказуем	nepredskazuyem	ne pred skaz u yem	skaz
непрекращающихся	neprekraschayuschihsya	ne prekra<sch> a yusch ih sya	prekra<sch>
непривитое	neprivitoye	ne pri vi t oye	vi
непривитые	neprivityye	ne pri vi t yye	vi
непридведенные	nepridvedennyye	ne prid ved enn yye	ved
непросто	neprosto	ne prost o	prost
нервной	nervnoy	nerv n oy	nerv
нереально	nereal'no	ne real'n o	real'n
нескольких	neskol'kih	ne skol'k ih	skol'k
Несколько	Neskol'ko	Ne skol'k o	skol'k
неслышала	neslyshala	ne slysh a l a	slysh
Несмотря	Nesmotrya	Ne smotr ya	smotr
несших	nesshih	nes<sh> ih	nes<sh>
неужели	neuzheli	neuzheli	neuzheli
нечто	nechto	ne chto	chto
низменной	nizmennoy	niz menn oy	menn
никак	nikak	ni kak	kak
никаких	nikakih	ni kak ih	kak
никогда	nikogda	ni kogda	kogda
никому	nikomu	ni k omu	k
новое	novoye	nov oye	nov
новостей	novostey	novost ey	novos
Новости	Novosti	Novost i	Novost
Новый	Novyy	Nov yy	Nov
новых	novyh	nov yh	nov
номер	nomer	nomer	nomer
нормальном	normal'nom	norm al'n om	norm
нормальными	normal'nymi	norm al'n ymi	norm
норме	norme	norm e	norm
носителем	nositelem	nos i tel em	nos
Носителем	Nositelem	Nos i tel em	Nos
ночи	nochi	noch i	noch
ночь	noch'	noch'	noch'
ноябрю	noyabryu	noyabr yu	noyabr
Ну	Nu	Nu	Nu
нужд	nuzhd	nuzhd	nuzhd
нуждается	nuzhdayetsya	nuzhd a yet sya	nuzhd
нуждающимся	nuzhdayuschimsya	nuzhd a yusch im sya	nuzhd
нынешнему	nyneshnemu	nyne shn emu	nyne
об	ob	ob	ob
обеспечении	obespechenii	obespech eni i	obespech
обеспечивал	obespechival	obespech iva l	obespech
обесточить	obestochit'	o bes toch i t'	toch
обещало	obeschalo	obesch a l o	obesch
обладает	obladayet	oblada yet	oblada
области	oblasti	oblast i	oblast
областного	oblastnogo	oblast n ogo	oblast
область	oblast'	oblast'	oblast'
областям	oblastyam	oblast yam	oblast
областях	oblastyah	oblast yah	oblast
облачностью	oblachnost'yu	obla<ch> n ost' yu	obla<ch>
обломками	oblomkami	ob lom k ami	lom
обломком	oblomkom	ob lom k om	lom
обнадежил	obnadezhil	ob nadezh i l	nadezh
обозначены	oboznacheny	obo zna<ch> en y	zna<ch>
Обозреватель	Obozrevatel'	Obo zr e va tel'	zr
обороне	oborone	oboron e	oboron
образуя	obrazuya	obraz u ya	obraz
обрушилась	obrushilas'	ob rush i l a s'	rush
обрушился	obrushilsya	ob rush i l sya	rush
обстановка	obstanovka	obstanovk a	obstanovk
обстановки	obstanovki	obstanovk i	obstanovk
обстрелом	obstrelom	ob strel om	strel
обсуждают	obsuzhdayut	ob suzhd a yut	suzhd
общественного	obschestvennogo	obsch e stv enn ogo	obsch
общую	obschuyu	obsch uyu	obsch
объектов	ob"yektov	ob"yekt ov	ob"yekt
объявлен	ob"yavlen	ob"yavl en	ob"yavl
объявлена	ob"yavlena	ob"yavl en a	ob"yavl
обычными	obychnymi	obychn ymi	obychn
овощах	ovoschah	ovosch ah	ovosch
Оглавление	Oglavleniye	O glavl eni ye	glavl
ограничение	ogranicheniye	o grani<ch> eni ye	grani<ch>
ограничению	ogranicheniyu	o grani<ch> eni yu	grani<ch>
огромные	ogromnyye	ogromn yye	ogromn
огромным	ogromnym	ogromn ym	ogromn
одежде	odezhde	odezhd e	odezhd
Одесской	Odesskoy	Odess k oy	Odess
Одессой	Odessoy	Odess oy	Odess
одеял	odeyal	odeyal	odeyal
Одна	Odna	Odn a	Odn
одним	odnim	odn im	odn
озеро	ozero	ozer o	ozer
оказавшимся	okazavshimsya	okaz a vsh im sya	okaz
оказанию	okazaniyu	okaz a ni yu	okaz
оказать	okazat'	okaz a t'	okaz
оказаться	okazat'sya	okaz a t' sya	okaz
оказывается	okazyvayetsya	okaz yva yet sya	okaz
Оказывается	Okazyvayetsya	Okaz yva yet sya	Okaz
оказывают	okazyvayut	okaz yva yut	okaz
океанический	okeanicheskiy	okean ichesk iy	okean
около	okolo	okolo	okolo
окончание	okonchaniye	o konch a ni ye	konch
окончания	okonchaniya	o konch a ni ya	konch
окрестности	okrestnosti	okrest n ost i	okrest
окрестностях	okrestnostyah	okrest n ost yah	okrest
округах	okrugah	okrug ah	okrug
Омске	Omske	Omsk e	Omsk
он	on	on	on
опасного	opasnogo	opasn ogo	opasn
опасным	opasnym	opasn ym	opasn
опасными	opasnymi	opasn ymi	opasn
операцию	operatsiyu	oper atsi yu	oper
оповещения	opovescheniya	opo ve<sch> eni ya	ve<sch>
определяют	opredelyayut	opredel ya yut	opredel
Опубликовано	Opublikovano	O publik ov a n o	publik
опытные	opytnyye	opyt n yye	opyt
опыту	opytu	opyt u	opyt
оранжевый	oranzhevyy	oranzhev yy	oranzhev
организации	organizatsii	organ iz atsi i	organ
Организация	Organizatsiya	Organ iz atsi ya	Organ
организм	organizm	organ izm	organ
организованно	organizovanno	organ iz ova nn o	organ
организовано	organizovano	organ iz ova n o	organ
организовать	organizovat'	organ iz ova t'	organ
освещение	osvescheniye	o sve<sch> eni ye	sve<sch>
ослабевает	oslabevayet	o slab e va yet	slab
ослабление	oslableniye	o slabl eni ye	slabl
ослабляет	oslablyayet	o slabl ya yet	slabl
Осложнениями	Oslozhneniyami	O slozhn eni yami	slozhn
осложнившихся	oslozhnivshihsya	o slozhn i vsh ih sya	slozhn
основания	osnovaniya	osnov a ni ya	osnov
основном	osnovnom	osnov n om	osnov
основные	osnovnyye	osnov n yye	osnov
основными	osnovnymi	osnov n ymi	osnov
основу	osnovu	osnov u	osnov
особого	osobogo	osob ogo	osob
оставил	ostavil	osta v i l	osta
Остальных	Ostal'nyh	Ostal'n yh	Ostal'n
останешься	ostanesh'sya	osta n esh' sya	osta
остановила	ostanovila	ostanov i l a	ostanov
остановке	ostanovke	ostanov k e	ostanov
остатками	ostatkami	osta t k ami	osta
Остаются	Ostayutsya	Osta yut sya	Osta
острове	ostrove	ostrov e	ostrov
остроту	ostrotu	ostrot u	ostrot
осуществлялось	osuschestvlyalos'	osuschestvl ya l os'	osuschestvl
отвергла	otvergla	ot verg l a	verg
ответил	otvetil	otvet i l	otvet
отдавать	otdavat'	ot da va t'	da
отдаленный	otdalennyy	ot dal enn yy	dal
отдыхающих	otdyhayuschih	otdyh a yusch ih	otdyh
откажутся	otkazhutsya	otka<zh> ut sya	otka<zh>
отказа	otkaza	otkaz a	otkaz
отключен	otklyuchen	ot klyuch en	klyuch
отключений	otklyucheniy	ot klyuch en iy	klyuch
открещиваются	otkreschivayutsya	ot kre<sch> iva yut sya	kre<sch>
открывавшиеся	otkryvavshiyesya	ot kry va vsh iye sya	kry
открылся	otkrylsya	ot kry l sya	kry
открыто	otkryto	ot kry t o	kry
откуда	otkuda	ot kuda	kuda
отметила	otmetila	ot met i la	met
отметки	otmetki	ot met k i	met
отмечается	otmechayetsya	ot me<ch> a yet sya	me<ch>
относился	otnosilsya	ot nos i l sya	nos
относится	otnositsya	ot nos it sya	nos
относящимися	otnosyaschimisya	ot nos yasch imi sya	nos
отражается	otrazhayetsya	otra<zh> a yet sya	otra<zh>
отражённого	otrazhonnogo	otra<zh> onn ogo	otra<zh>
отсевоблоков	otsevoblokov	ot sev o blok ov	sev blok
официально	ofitsial'no	ofitsial'n o	ofitsial'n
официального	ofitsial'nogo	ofitsial'n ogo	ofitsial'n
официальное	ofitsial'noye	ofitsial'n oye	ofitsial'n
Официальные	Ofitsial'nyye	Ofitsial'n yye	Ofitsial'n
охлаждающий	ohlazhdayuschiy	o hla<zh>d a yusch iy	hla<zh>d
охотничьего	ohotnich'yego	ohot ni<ch'> yego	ohot
Охотского	Ohotskogo	Ohot sk ogo	Ohot
оценивается	otsenivayetsya	o tsen iva yet sya	tsen
оценивающей	otsenivayuschey	o tsen iva yusch ey	tsen
очевидцев	ochevidtsev	och e vid ts ev	och vid
очереди	ocheredi	ochered i	ochered
Очередной	Ocherednoy	Ochered n oy	Ochered
очередь	ochered'	ochered'	ochered'
очёнь	ochon'	ochon'	ochon'
Оша	Osha	Osh a	Osh
ошарашен	osharashen	o shara<sh> en	shara<sh>
ошибку	oshibku	o shib k u	shib
ощущались	oschuschalis'	oschu<sch> a l is'	oschu<sch>
паводковой	pavodkovoy	pa vod k ov oy	vod
паводок	pavodok	pa vod ok	vod
падает	padayet	pad a yet	pad
Пакистане	Pakistane	Pakistan e	Pakistan
Пакистаном	Pakistanom	Pakistan om	Pakistan
пакистанской	pakistanskoy	pakistan sk oy	pakistan
палатками	palatkami	palatk ami	palatk
палатках	palatkah	palatk ah	palatk
палочкой	palochkoy	paloch k oy	paloch
панику	paniku	panik u	panik
патронажем	patronazhem	patron azh em	patron
пациентов	patsiyentov	patsiyent ov	patsiyent
пепел	pepel	pepel	pepel
пеплом	peplom	pepl om	pepl
первая	pervaya	perv aya	perv
Первая	Pervaya	Perv aya	Perv
первичный	pervichnyy	perv ichn yy	perv
первой	pervoy	perv oy	perv
первоначально	pervonachal'no	perv o na cha l' n o	perv
первоначальных	pervonachal'nyh	perv o na cha l' n yh	perv
первую	pervuyu	perv uyu	perv
Первые	Pervyye	Perv yye	Perv
переда	pereda	pered a	pered
передаваться	peredavat'sya	pere da va t' sya	da
передаётся	peredayotsya	pere da yot sya	da
переживаем	perezhivayem	pere zhi va yem	zhi
переживает	perezhivayet	pere zhi va yet	zhi
переживающему	perezhivayuschemu	pere zhi va yusch emu	zhi
переживающими	perezhivayuschimi	pere zhi va yusch imi	zhi
перекликаются	pereklikayutsya	pere klik a yut sya	klik
перекрыты	perekryty	pere kry t y	kry
перелеты	perelety	pere let y	let
перемещались	peremeschalis'	pere me<sch> a l i s'	me<sch>
перемещаться	peremeschat'sya	pere me<sch> a t' sya	me<sch>
переносимый	perenosimyy	pere nos im yy	nos
переносчиками	perenoschikami	pere nos chik ami	nos
переполнены	perepolneny	pere poln en y	poln
переполняла	perepolnyala	pere poln ya l a	poln
перепродают	pereprodayut	pere proda yut	proda
переселиться	pereselit'sya	pere sel i t' sya	sel
переходит	perehodit	pere hod it	hod
персонал	personal	personal	personal
персонала	personala	personal a	personal
перспективными	perspektivnymi	perspektiv n ymi	perspektiv
печальной	pechal'noy	pechal' n oy	pechal'
печальный	pechal'nyy	pechal' n yy	pechal'
печенье	pechen'ye	pech en' ye	pech
пешеходов	peshehodov	pesh e hod ov	pesh
пик	pik	pik	pik
питание	pitaniye	pit a ni ye	pit
питаться	pitat'sya	pit a t' sya	pit
питьевая	pit'yevaya	pi t' yev aya	pi
пишет	pishet	pish et	pish
планетную	planetnuyu	planet n uyu	planet
Плановая	Planovaya	Plan ov aya	Plan
плену	plenu	plen u	plen
плотине	plotine	plotin e	plotin
площадей	ploschadey	ploschad ey	ploschad
площади	ploschadi	ploschad i	ploschad
площадь	ploschad'	ploschad'	ploschad'
пневмония	pnevmoniya	pnevmon i ya	pnevmon
По	Po	Po	Po
побережью	poberezh'yu	po bere<zh>' yu	bere<zh>'
побывали	pobyvali	po by va l i	by
поверхностных	poverhnostnyh	po verh n ost n yh	verh
повлекшее	povleksheye	po vlek sh eye	vlek
поводу	povodu	povod u	povod
повреждения	povrezhdeniya	po vrezhd eni ya	vrezhd
повреждены	povrezhdeny	po vrezhd en y	vrezhd
повтор	povtor	povtor	povtor
повторение	povtoreniye	povtor eni ye	povtor
повторится	povtoritsya	povtor i t sya	povtor
повысив	povysiv	po vys i v	vys
погодными	pogodnymi	pogod n ymi	pogod
погодой	pogodoy	pogod oy	pogod
пограничных	pogranichnyh	po grani<ch> n yh	grani<ch>
погребенные	pogrebennyye	pogreb enn yye	pogreb
Под	Pod	Pod	Pod
подавить	podavit'	po dav i t'	dav
Подавляющее	Podavlyayuscheye	Po davl ya yusch eye	davl
подвергаются	podvergayutsya	podverg a yut sya	podverg
подвержены	podverzheny	podver<zh> en y	podver<zh>
подвизались	podvizalis'	pod viz a l is'	viz
подвозивший	podvozivshiy	pod voz i vsh iy	voz
подготовки	podgotovki	pod gotov k i	gotov
подевалась	podevalas'	po de va l a s'	de
подержанный	poderzhannyy	po derzh a nn yy	derzh
подземных	podzemnyh	pod zem n yh	zem
подлежат	podlezhat	podlezh at	podlezh
Поднебесной	Podnebesnoy	Pod neb es n oy	neb
поднятия	podnyatiya	podnya ti ya	podnya
подобная	podobnaya	podob n aya	podob
Подобное	Podobnoye	Podob n oye	Podob
подопытным	podopytnym	pod opyt n ym	opyt
подорвали	podorvali	podo rv a l i	rv
подорвался	podorvalsya	podo rv a l sya	rv
подошла	podoshla	po do sh l a	sh
подписан	podpisan	pod pis a n	pis
подробности	podrobnosti	podrobn ost i	podrobn
подростки	podrostki	pod rost k i	rost
подросток	podrostok	pod rost ok	rost
подсоединяются	podsoyedinyayutsya	pod so yedin ya yut sya	yedin
подтвердили	podtverdili	podtverd i l i	podtverd
подтвердился	podtverdilsya	podtverd i l sya	podtverd
подтверждает	podtverzhdayet	podtver<zh>d a yet	podtver<zh>
подтвержденных	podtverzhdennyh	podtver<zh>d enn yh	podtver<zh>d
подтопления	podtopleniya	pod topl eni ya	topl
подтоплено	podtopleno	pod topl en o	topl
подтоплены	podtopleny	pod topl en y	topl
подходящего	podhodyaschego	pod hod yasch ego	hod
подчас	podchas	podchas	podchas
подчеркнул	podcherknul	pod cherk nu l	cherk
подъем	pod"yem	pod"yem	pod"yem
подъёма	pod"yoma	pod"yom a	pod"yom
пожарных	pozharnyh	pozhar n yh	pozhar
позади	pozadi	po zad i	zad
позапрошлой	pozaproshloy	po za pro sh l oy	pro
поздняя	pozdnyaya	pozdn yaya	pozdn
поиски	poiski	po isk i	isk
Поистине	Poistine	Po istin e	istin
пойдёт	poydot	po yd ot	yd
пока	poka	poka	poka
Пока	Poka	Poka	Poka
Показали	Pokazali	Pokaz a l i	Pokaz
показало	pokazalo	pokaz a l o	pokaz
показывает	pokazyvayet	pokaz yva yet	pokaz
покинут	pokinut	po ki n ut	ki
покинуть	pokinut'	po ki nu t'	ki
покончил	pokonchil	po konch i l	konch
покрова	pokrova	po krov a	krov
покрывающий	pokryvayuschiy	po kry va yusch iy	kry
покрылись	pokrylis'	po kry l i s'	kry
полеты	polety	po let y	let
поликлиниках	poliklinikah	poli klinik ah	klinik
поликлинике	poliklinike	poli klinik e	klinik
полицейского	politseyskogo	politsey sk ogo	politsey
полном	polnom	poln om	poln
полностью	polnost'yu	poln ost' yu	poln
половина	polovina	polovin a	polovin
полуострове	poluostrove	pol u ostrov e	pol ostrov
полутора	polutora	pol u tor a	pol tor
получившая	poluchivshaya	poluch i vsh aya	poluch
получила	poluchila	poluch i l a	poluch
получило	poluchilo	poluch i l o	poluch
получить	poluchit'	poluch i t'	poluch
полюбоваться	polyubovat'sya	po lyub ova t' sya	lyub
поля	polya	pol ya	pol
поляков	polyakov	pol yak ov	pol
полях	polyah	pol yah	pol
помню	pomnyu	pomn yu	pomn
помогают	pomogayut	po mog a yut	mog
помогло	pomoglo	po mog l o	mog
помощи	pomoschi	po mosch i	mosch
понеслось	poneslos'	po nes l o s'	nes
пониженным	ponizhennym	po ni<zh> enn ym	ni<zh>
понял	ponyal	ponya l	ponya
поняла	ponyala	ponya l a	ponya
попавшими	popavshimi	popa vsh i mi	popa
попадание	popadaniye	popad a ni ye	popad
попало	popalo	popa l o	popa
попробовать	poprobovat'	po prob ova t'	prob
порадовать	poradovat'	po rad ova t'	rad
поражает	porazhayet	po ra<zh> a yet	ra<zh>
поражен	porazhen	po ra<zh> en	ra<zh>
поражением	porazheniyem	po ra<zh> eni yem	ra<zh>
породившей	porodivshey	po rod i vsh ey	rod
породы	porody	porod y	porod
порядке	poryadke	poryadk e	poryadk
поселений	poseleniy	po sel eni y	sel
посещал	poseschal	posesch a l	posesch
посещении	poseschenii	posesch eni i	posesch
послал	poslal	po sl a l	sl
последнего	poslednego	posledn ego	posledn
Последнее	Posledneye	Posledn eye	Posledn
Последняя	Poslednyaya	Posledn yaya	Posledn
последовало	posledovalo	po sled ova l o	sled
последствий	posledstviy	po sled stv iy	sled
последствиям	posledstviyam	po sled stv i yam	sled
послужил	posluzhil	po slu<zh> i l	slu<zh>
посмотреть	posmotret'	po smotr e t'	smotr
посоветовали	posovetovali	po sovet ova l i	sovet
посольства	posol'stva	po sol' stv a	sol'
посольством	posol'stvom	po sol' stv om	sol'
поставили	postavili	po stav i l i	stav
поставить	postavit'	po stav i t'	stav
постепенно	postepenno	postepenn o	postepenn
постоянными	postoyannymi	postoyann ymi	postoyann
пострадавшей	postradavshey	po strad a vsh ey	strad
пострадавшем	postradavshem	po strad a vsh em	strad
построенная	postroyennaya	po stro yenn aya	stro
поступает	postupayet	postup a yet	postup
поступало	postupalo	postup a l o	postup
Поступают	Postupayut	Postup a yut	Postup
потенциальных	potentsial'nyh	potentsial' n yh	potentsial'
потерь	poter'	po ter'	ter'
потерял	poteryal	po ter ya l	ter
потоки	potoki	potok i	potok
потомки	potomki	potom k i	potom
потоп	potop	potop	potop
Потоп	Potop	Potop	Potop
потопал	potopal	po top a l	top
потребления	potrebleniya	potrebl eni ya	potrebl
потребностей	potrebnostey	po treb n ost ey	treb
потряхивает	potryahivayet	po tryah iva yet	tryah
потухшим	potuhshim	po tuh sh im	tuh
похожие	pohozhiye	po ho<zh> iye	ho<zh>
похолодания	poholodaniya	po holod a ni ya	holod
почвы	pochvy	pochv y	pochv
почитать	pochitat'	po chit a t'	chit
Почти	Pochti	Pochti	Pochti
почувствовали	pochuvstvovali	po chu v stv ova l i	chu
пошёл	poshol	po sho l	sho
пошла	poshla	po sh l a	sh
появиться	poyavit'sya	po yav i t' sya	yav
появление	poyavleniye	po yavl eni ye	yavl
появления	poyavleniya	po yavl eni ya	yavl
правило	pravilo	pravil o	pravil
Правильно	Pravil'no	Pravil' n o	Pravil'
правительственного	pravitel'stvennogo	prav i tel' stv enn ogo	prav
правительство	pravitel'stvo	prav i tel' stv o	prav
практике	praktike	prakt ik e	prakt
превысил	prevysil	pre vys i l	vys
превышает	prevyshayet	pre vy<sh> a yet	vy<sh>
превышать	prevyshat'	pre vy<sh> a t'	vy<sh>
превышении	prevyshenii	pre vy<sh> eni i	vy<sh>
предельном	predel'nom	predel' n om	predel'
предлагает	predlagayet	predlag a yet	predlag
предложила	predlozhila	predlo<zh> i l a	predlo<zh>
предостережением	predosterezheniyem	pred ostere<zh> eni yem	ostere<zh>
предположения	predpolozheniya	predpolo<zh> eni ya	predpolo<zh>
предположительно	predpolozhitel'no	predpolo<zh> i tel'n o	predpolo<zh>
предпринимает	predprinimayet	predprinim a yet	predprinim
предсказали	predskazali	pred skaz a l i	skaz
представил	predstavil	predstav i l	predstav
представители	predstaviteli	predstav i tel i	predstav
представитель	predstavitel'	predstav i tel'	predstav
представителя	predstavitelya	predstav i tel ya	predstav
представить	predstavit'	predstav i t'	predstav
предупреждает	preduprezhdayet	preduprezhd a yet	preduprezhd
предупреждали	preduprezhdali	preduprezhd a l i	preduprezhd
предупреждают	preduprezhdayut	preduprezhd a yut	preduprezhd
предупреждением	preduprezhdeniyem	preduprezhd eni yem	preduprezhd
предшествовал	predshestvoval	pred she stv ova l	she
предшествовала	predshestvovala	pred she stv ova l a	she
предыдущие	predyduschiye	pred yd usch iye	yd
предыдущих	predyduschih	pred yd usch ih	yd
президенту	prezidentu	prezident u	prezident
прекрасная	prekrasnaya	prekrasn aya	prekrasn
прекрасный	prekrasnyy	prekrasn yy	prekrasn
прекратились	prekratilis'	prekrat i l i s'	prekrat
прекратит	prekratit	prekrat it	prekrat
прекращения	prekrascheniya	prekra<sch> eni ya	prekra<sch>
преодолела	preodolela	pre odol e l a	odol
прервать	prervat'	pre rv a t'	rv
пресной	presnoy	presn oy	presn
привезли	privezli	pri vez l i	vez
привела	privela	pri ve l a	ve
привести	privesti	pri vest i	vest
прививкам	privivkam	pri vi v k am	vi
прививках	privivkah	pri vi v k ah	vi
Прививки	Privivki	Pri vi v k i	vi
прививок	privivok	pri vi v ok	vi
привитых	privityh	pri vi t yh	vi
приводит	privodit	pri vod it	vod
приехали	priyehali	pri yeh a l i	yeh
призвала	prizvala	pri zv a l a	zv
приземлилось	prizemlilos'	pri zeml i l o s'	zeml
признаком	priznakom	priznak om	priznak
признал	priznal	prizna l	prizna
призывом	prizyvom	pri zyv om	zyv
применяемые	primenyayemyye	primen ya yem yye	primen
принесет	prineset	pri nes et	nes
принца	printsa	prints a	prints
принципу	printsipu	printsip u	printsip
приняли	prinyali	prinya l i	prinya
приостановленными	priostanovlennymi	pri ostanovl enn ymi	ostanovl
припоминаю	pripominayu	pri pomin a yu	pomin
припомнить	pripomnit'	pri pomn i t'	pomn
природа	priroda	prirod a	prirod
Природа	Priroda	Prirod a	Prirod
природной	prirodnoy	prirod n oy	prirod
присвоен	prisvoyen	pri svo yen	svo
притоками	pritokami	pri tok ami	tok
притоках	pritokah	pri tok ah	tok
причинам	prichinam	prichin am	prichin
причинен	prichinen	prichin en	prichin
причины	prichiny	prichin y	prichin
пришел	prishel	pri she l	she
пришло	prishlo	pri sh l o	sh
проведена	provedena	pro ved en a	ved
проведены	provedeny	pro ved en y	ved
провиантом	proviantom	proviant om	proviant
провинций	provintsiy	provintsi y	provintsi
проводят	provodyat	pro vod yat	vod
проволочный	provolochnyy	provolo<ch> n yy	provolo<ch>
программы	programmy	programm y	programm
продажу	prodazhu	proda zh u	proda
продемонстрировали	prodemonstrirovali	pro demonstr ir ova l i	demonstr
продовольственные	prodovol'stvennyye	prodovol'stv enn yye	prodovol'stv
продовольствие	prodovol'stviye	prodovol'stv i ye	prodovol'stv
продовольствия	prodovol'stviya	prodovol'stv i ya	prodovol'stv
продолжает	prodolzhayet	prodol<zh> a yet	prodol<zh>
продолжал	prodolzhal	prodol<zh> a l	prodol<zh>
продолжались	prodolzhalis'	prodol<zh> a l i s'	prodol<zh>
продолжают	prodolzhayut	prodol<zh> a yut	prodol<zh>
продолжая	prodolzhaya	prodol<zh> a ya	prodol<zh>
продолжили	prodolzhili	prodol<zh> i l i	prodol<zh>
продуктов	produktov	produkt ov	produkt
продукции	produktsii	produkts i i	produkts
проектировщиков	proyektirovschikov	proyekt ir ov schik ov	proyekt
произведенную	proizvedennuyu	proizved enn u yu	proizved
производитель	proizvoditel'	proizvod i tel'	proizvod
произнесено	proizneseno	proiznes en o	proiznes
происходило	proishodilo	prois hod i l o	hod
Происшествия	Proisshestviya	Prois <sh>e stv i ya	<sh>e
прокомментировал	prokommentiroval	pro komment ir ova l	komment
пролив	proliv	proliv	proliv
проливные	prolivnyye	pro li v n yye	li
прольются	prol'yutsya	pro l' yut sya	l'
промокшего	promokshego	pro mok sh ego	mok
пропавших	propavshih	propa vsh ih	propa
пропали	propali	propa l i	propa
просочиться	prosochit'sya	pro soch i t' sya	soch
проспекту	prospektu	prospekt u	prospekt
простейшие	prosteyshiye	prost eysh iye	prost
просьбой	pros'boy	pros' b oy	pros'
протекает	protekayet	pro tek a yet	tek
протеста	protesta	protest a	protest
протесты	protesty	protest y	protest
против	protiv	protiv	protiv
противопаводковую	protivopavodkovuyu	protiv o pa vod k ov uyu	protiv vod
противостояния	protivostoyaniya	protiv o sto ya ni ya	protiv sto
противоэпидемические	protivoepidemicheskiye	protiv o epidem ichesk iye	protiv epidem
проходить	prohodit'	pro hod i t'	hod
проценты	protsenty	protsent y	protsent
процесс	protsess	protsess	protsess
прочие	prochiye	proch iye	proch
прошедшей	proshedshey	pro shed sh ey	shed
прошлым	proshlym	pro sh l ym	sh
прошлых	proshlyh	pro sh l yh	sh
прошу	proshu	prosh u	prosh
прямой	pryamoy	pryam oy	pryam
пунктов	punktov	punkt ov	punkt
пункты	punkty	punkt y	punkt
пустил	pustil	pust i l	pust
пустыне	pustyne	pust yn e	pust
пустыни	pustyni	pust yn i	pust
пытаются	pytayutsya	pyt a yut sya	pyt
пытаясь	pytayas'	pyt a ya s'	pyt
пятеро	pyatero	pyat er o	pyat
пяти	pyati	pyat i	pyat
пятницу	pyatnitsu	pyat nits u	pyat
пятой	pyatoy	pyat oy	pyat
рабами	rabami	rab ami	rab
работает	rabotayet	rabot a yet	rabot
работали	rabotali	rabot a l i	rabot
работах	rabotah	rabot ah	rabot
работают	rabotayut	rabot a yut	rabot
работники	rabotniki	rabot nik i	rabot
работников	rabotnikov	rabot nik ov	rabot
Рабочие	Rabochiye	Raboch iye	Raboch
равнинное	ravninnoye	ravn in n oye	ravn
равно	ravno	ravn o	ravn
равняется	ravnyayetsya	ravn ya yet sya	ravn
радиационная	radiatsionnaya	rad i atsi onn aya	rad
разгар	razgar	raz gar	gar
разговоре	razgovore	raz govor e	govor
различаются	razlichayutsya	raz li<ch> a yut sya	li<ch>
различной	razlichnoy	raz li<ch> n oy	li<ch>
разложившимся	razlozhivshimsya	raz lozh i vsh im sya	lozh
разлом	razlom	raz lom	lom
разлома	razloma	raz lom a	lom
размахивая	razmahivaya	raz mah iva ya	mah
Размещение	Razmescheniye	Raz me<sch> eni ye	me<sch>
размножения	razmnozheniya	raz mno<zh> eni ya	mno<zh>
разновидности	raznovidnosti	razn o vid n ost i	razn vid
разослали	razoslali	razo sl a l i	sl
разразилась	razrazilas'	razraz i l a s'	razraz
разрушают	razrushayut	raz rush a yut	rush
разрушениях	razrusheniyah	raz rush eni yah	rush
Разрушенная	Razrushennaya	Raz rush enn aya	rush
разрушенных	razrushennyh	raz rush enn yh	rush
разрушено	razrusheno	raz rush en o	rush
разрушила	razrushila	raz rush i l a	rush
разрушительного	razrushitel'nogo	raz rush i tel'n ogo	rush
разрушительное	razrushitel'noye	raz rush i tel'n oye	rush
Разумеется	Razumeyetsya	Raz um e yet sya	um
района	rayona	rayon a	rayon
районе	rayone	rayon e	rayon
районов	rayonov	rayon ov	rayon
ракетный	raketnyy	raket n yy	raket
Ракетных	Raketnyh	Raket n yh	Raket
ранений	raneniy	ran eni y	ran
раненые	ranenyye	ran en yye	ran
раненых	ranenyh	ran en yh	ran
ранним	rannim	ran n im	ran
раскинуты	raskinuty	ras ki nu t y	ki
располагается	raspolagayetsya	ras po lag a yet sya	lag
располагаются	raspolagayutsya	ras po lag a yuts ya	lag
расположенные	raspolozhennyye	ras po lo<zh> enn yye	lo<zh>
расположенный	raspolozhennyy	ras po lo<zh> enn yy	lo<zh>
расположены	raspolozheny	ras po lo<zh> en y	lo<zh>
распространение	rasprostraneniye	rasprostran eni ye	rasprostran
распространилась	rasprostranilas'	rasprostran i l a s'	rasprostran
рассеиваться	rasseivat'sya	ras se iva t' sya	se
рассказывает	rasskazyvayet	ras skaz yva yet	skaz
рассказывают	rasskazyvayut	ras skaz yva yut	skaz
расследование	rassledovaniye	ras sled ova ni ye	sled
расстреляли	rasstrelyali	ras strel ya l i	strel
расстреляло	rasstrelyalo	ras strel ya l o	strel
расстройство	rasstroystvo	ras stroy stv o	stroy
растет	rastet	ra<st> et	ra<st>
расти	rasti	ra<st> i	ra<st>
расходов	rashodov	ras hod ov	hod
расходует	rashoduyet	ras hod u yet	hod
реакторное	reaktornoye	reaktor n oye	reaktor
реально	real'no	real'n o	real'n
реальны	real'ny	real'n y	real'n
ребенка	rebenka	reb enk a	reb
ревакцинация	revaktsinatsiya	re vaktsin atsi ya	vaktsin
региона	regiona	region a	region
регулирующими	reguliruyuschimi	regul ir u yusch imi	regul
регуляции	regulyatsii	regul yatsi i	regul
Редакци	Redaktsi	Redakts i	Redakts
режиме	rezhime	rezhim e	rezhim
резал	rezal	rez a l	rez
резервуаров	rezervuarov	rezervuar ov	rezervuar
резко	rezko	rezk o	rezk
реки	reki	rek i	rek
рекорд	rekord	rekord	rekord
рекордный	rekordnyy	rekord n yy	rekord
рекордов	rekordov	rekord ov	rekord
ремонт	remont	remont	remont
республиканский	respublikanskiy	respublik an sk iy	respublik
республики	respubliki	respublik i	respublik
ресурсы	resursy	resurs y	resurs
речь	rech'	rech'	rech'
решена	reshena	resh en a	resh
решетки	reshetki	reshetk i	reshetk
рис	ris	ris	ris
риска	riska	risk a	risk
ровно	rovno	rovn o	rovn
ровной	rovnoy	rovn oy	rovn
родину	rodinu	rod in u	rod
родных	rodnyh	rodn yh	rodn
Розалии	Rozalii	Rozali i	Rozali
Росздравнадзор	Roszdravnadzor	Ros zdrav nadzor	Ros zdrav nadzor
Роспотребнадзор	Rospotrebnadzor	Ros potreb nadzor	Ros potreb nadzor
Российские	Rossiyskiye	Ross iy sk iye	Ross
российского	rossiyskogo	ross iy sk ogo	ross
Россия	Rossiya	Ross i ya	Ross
ротации	rotatsii	rot atsi i	rot
ротовой	rotovoy	rot ov oy	rot
ружья	ruzh'ya	ruzh' ya	ruzh'
руками	rukami	ruk ami	ruk
руки	ruki	ruk i	ruk
русло	ruslo	rusl o	rusl
русне	rusne	rusn e	rusn
русским	russkim	rus sk im	rus
рухнувшего	ruhnuvshego	ruh nu vsh ego	ruh
ряда	ryada	ryad a	ryad
Сайга	Sayga	Sayg a	Sayg
салоне	salone	salon e	salon
Самаком	Samakom	Samak om	Samak
Самая	Samaya	Sam aya	Sam
самого	samogo	sam ogo	sam
Самое	Samoye	Sam oye	Sam
самолеты	samolety	sam o let y	sam let
самые	samyye	sam yye	sam
Самые	Samyye	Sam yye	Sam
самым	samym	sam ym	sam
Санкции	Sanktsii	Sanktsi i	Sanktsi
Сахалине	Sahaline	Sahalin e	Sahalin
сбоям	sboyam	s bo yam	bo
сбоях	sboyah	s bo yah	bo
сбрасывать	sbrasyvat'	s br<a>s yva t'	br<a>s
сброс	sbros	s bros	bros
сбывают	sbyvayut	sby va yut	sby
свадебный	svadebnyy	svad eb n yy	svad
сведения	svedeniya	s ved eni ya	ved
Свердловскую	Sverdlovskuyu	Sverdlov sk uyu	Sverdlov
свет	svet	svet	svet
света	sveta	svet a	svet
свето	sveto	svet o	svet
Свидетельство	Svidetel'stvo	Svide tel' stv o	Svide
Свидетелями	Svidetelyami	Svide tel yami	Svide
Свои	Svoi	Svo i	Svo
своих	svoih	svo ih	svo
свыше	svyshe	s vysh e	vysh
связан	svyazan	s vyaz an	vyaz
связанный	svyazannyy	s vyaz ann yy	vyaz
связях	svyazyah	s vyaz yah	vyaz
священнослужителям	svyaschennosluzhitelyam	svyasch enn o sluzh i tel yam	svyasch sluzh
сгустили	sgustili	s gust i l i	gust
сдать	sdat'	s da t'	da
сдаче	sdache	s da ch e	da
сделал	sdelal	s del a l	del
северную	severnuyu	sever n uyu	sever
северный	severnyy	sever n yy	sever
сейсмическую	seysmicheskuyu	seysm i<ch> esk uyu	seysm
сейчас	seychas	seychas	seychas
Сейчас	Seychas	Seychas	Seychas
секретарь	sekretar'	sekretar'	sekretar'
секторе	sektore	sektor e	sektor
села	sela	sel a	sel
сельские	sel'skiye	sel' sk iye	sel'
семей	semey	sem ey	sem
семидесяти	semidesyati	sem i desyat i	sem
семь	sem'	sem'	desyat
сентября	sentyabrya	sentyabr ya	sentyabr
Сербии	Serbii	Serb ii	Serb
серьезными	ser'yeznymi	ser'yez n ymi	ser'yez
Сибири	Sibiri	Sibir i	Sibir
сигнал	signal	signal	signal
силами	silami	sil ami	sil
силы	sily	sil y	sil
сильнейшего	sil'neyshego	sil' n eysh ego	sil'
сильные	sil'nyye	sil' n yye	sil'
симптомов	simptomov	simptom ov	simptom
симптомы	simptomy	simptom y	simptom
синоптиков	sinoptikov	sinoptik ov	sinoptik
систематическим	sistematicheskim	sistem at ichesk im	sistem
системы	sistemy	sistem y	sistem
ситуации	situatsii	situatsi i	situatsi
ситуация	situatsiya	situatsi ya	situatsi
сказал	skazal	skaz a l	skaz
сказали	skazali	skaz a l i	skaz
сказать	skazat'	skaz a t'	skaz
скину	skinu	s ki n u	ki
складе	sklade	sklad e	sklad
скользить	skol'zit'	skol'z i t'	skol'z
сколько	skol'ko	skol'k o	skol'k
скончалась	skonchalas'	s konch a l a s'	konch
скорее	skoreye	skor eye	skor
скоро	skoro	skor o	skor
скорость	skorost'	skor ost'	skor
Скорость	Skorost'	Skor ost'	Skor
скоростью	skorost'yu	skor ost' yu	skor
скрыли	skryli	skry l i	skry
скупали	skupali	s kup a l i	kup
Слабым	Slabym	Slab ym	Slab
слава	slava	slav a	slav
славилось	slavilos'	slav i l o s'	slav
следует	sleduyet	sled u yet	sled
следующего	sleduyuschego	sled u yusch ego	sled
следующий	sleduyuschiy	sled u yusch iy	sled
слепоте	slepote	slep ot e	slep
слизистые	slizistyye	sliz ist yye	sliz
Слово	Slovo	Slov o	Slov
слоем	sloyem	slo yem	slo
Случаи	Sluchai	Sluch a i	Sluch
случаю	sluchayu	sluch a yu	sluch
случаются	sluchayutsya	sluch a yut sya	sluch
случая	sluchaya	sluch a ya	sluch
случившегося	sluchivshegosya	sluch i vsh ego sya	sluch
случившееся	sluchivsheyesya	sluch i vsh eye sya	sluch
смертельным	smertel'nym	smert el'n ym	smert
смерти	smerti	smert i	smert
смерть	smert'	smert'	smert'
Смерть	Smert'	Smert'	Smert'
сметена	smetena	s met en a	met
смещается	smeschayetsya	s me<sch> a yet sya	me<sch>
смогла	smogla	s mog l a	mog
смогут	smogut	s mog ut	mog
смотря	smotrya	smotr ya	smotr
смягчает	smyagchayet	s myag<ch> a yet	myag<ch>
снега	snega	sneg a	sneg
снегопада	snegopada	sneg o pad a	sneg
снежной	snezhnoy	sne<zh> n oy	pad
снежном	snezhnom	sne<zh> n om	sne<zh>
снежных	snezhnyh	sne<zh> n yh	sne<zh>
снижении	snizhenii	s ni<zh> eni i	sne<zh>
снижения	snizheniya	s ni<zh> eni ya	ni<zh>
Снимки	Snimki	Snim k i	ni<zh>
Снимок	Snimok	Snim ok	Snim
со	so	so	Snim
собираемую	sobirayemuyu	so bir a yem uyu	bir
собрался	sobralsya	so br a l sya	br
собственно	sobstvenno	sobstvenn o	sobstvenn
событий	sobytiy	sobyti y	sobyti
совершаться	sovershat'sya	soversh a t' sya	soversh
совершающих	sovershayuschih	soversh a yusch ih	soversh
совершенно	sovershenno	sovershenn o	sovershenn
совместно	sovmestno	so vmest n o	vmest
современной	sovremennoy	so vrem en n oy	vrem
согласен	soglasen	soglas en	soglas
Согласно	Soglasno	Soglas n o	Soglas
сограждана	sograzhdana	so grazhd an a	grazhd
содействия	sodeystviya	sodeystv iya	sodeystv
сожалению	sozhaleniyu	sozhal e ni yu	sozhal
создали	sozdali	sozda l i	sozda
создана	sozdana	sozda n a	sozda
созданы	sozdany	sozda n y	sozda
создают	sozdayut	sozda yut	sozda
солнце	solntse	solnts e	solnts
сообщалось	soobschalos'	soobsch a l o s'	soobsch
сообщения	soobscheniya	soobsch eni ya	soobsch
сообщество	soobschestvo	so obsch estv o	obsch
сообществом	soobschestvom	so obsch estv om	obsch
сообщила	soobschila	soobsch i l a	soobsch
сообщили	soobschili	soobsch i l i	soobsch
соотечественники	sootechestvenniki	so otech estv enn ik i	otech
сопереживают	soperezhivayut	so pere zhi va yut	zhi
сопровождавшихся	soprovozhdavshihsya	so pro vozhd a vsh ih sya	vozhd
сопровождается	soprovozhdayetsya	so pro vozhd a yet sya	vozhd
Сосед	Sosed	Sosed	Sosed
соседней	sosedney	sosed n ey	sosed
состав	sostav	sostav	sostav
составит	sostavit	sostav it	sostav
составляет	sostavlyayet	sostavl ya yet	sostavl
сотен	soten	sot en	sot
сотрудника	sotrudnika	so trud nik a	trud
сотрудников	sotrudnikov	so trud nik ov	trud
сотрудницы	sotrudnitsy	so trud nits y	trud
сотрясло	sotryaslo	so tryas l o	tryas
сошедшей	soshedshey	so shed sh ey	shed
сошло	soshlo	so sh l o	sh
спад	spad	s pad	pad
спасает	spasayet	spas a yet	spas
спасли	spasli	spas l i	spas
специалисты	spetsialisty	spetsial ist y	spetsial
специально	spetsial'no	spetsial'n o	spetsial'n
специальную	spetsial'nuyu	spetsial'n uyu	spetsial'n
специальные	spetsial'nyye	spetsial'n yye	spetsial'n
специальный	spetsial'nyy	spetsial'n yy	spetsial'n
специальными	spetsial'nymi	spetsial'n ymi	spetsial'n
Спикер	Spiker	Spiker	Spiker
спланированный	splanirovannyy	s plan ir ova nn yy	plan
спорной	spornoy	spor n oy	spor
спровоцировала	sprovotsirovala	s provots ir ova l a	provots
Спутник	Sputnik	S put nik	put
спутниковых	sputnikovyh	s put nik ov yh	put
сравнения	sravneniya	sravn eni ya	sravn
сразу	srazu	s raz u	raz
среди	sredi	sredi	sredn
среднегодовым	srednegodovym	sredn e god ov ym	god
среднем	srednem	sredn em	sredn
Средний	Sredniy	Sredn iy	Sredn
средства	sredstva	sredstv a	sredstv
средствах	sredstvah	sredstv ah	sredstv
средством	sredstvom	sredstv om	sredstv
срочной	srochnoy	sro<ch> n oy	sro<ch>
ссылки	ssylki	s syl k i	syl
ста	sta	sta	sta
стажем	stazhem	stazh em	stazh
Стамбула	Stambula	Stambul a	Stambul
станет	stanet	sta n et	sta
становления	stanovleniya	stanovl eni ya	stanovl
станция	stantsiya	stantsi ya	stantsi
станциями	stantsiyami	stantsi yami	stantsi
старейших	stareyshih	star eysh ih	star
статус	status	status	status
статье	stat'ye	stat' ye	stat'
стенах	stenah	sten ah	sten
стены	steny	sten y	sten
Стихия	Stihiya	Stihi ya	Stihi
сто	sto	st o	st
стоит	stoit	sto it	sto
Стоит	Stoit	Sto it	Sto
стойкого	stoykogo	stoy k ogo	stoy
стока	stoka	s tok a	tok
стол	stol	stol	stol
столицу	stolitsu	stolits u	stolits
столкнуться	stolknut'sya	s tolk nu t' sya	tolk
столовую	stolovuyu	stol ov uyu	stol
стояли	stoyali	sto ya l i	sto
страдающих	stradayuschih	strada yusch ih	strada
страна	strana	stran a	stran
странах	stranah	stran ah	stran
странной	strannoy	strann oy	strann
страну	stranu	stran u	stran
стратовулкан	stratovulkan	strat o vulkan	strat vulkan
страховщик	strahovschik	strah ov sch ik	strah
строительства	stroitel'stva	stro i tel' stv a	stro
строителя	stroitelya	stro i tel ya	stro
строят	stroyat	stro yat	stro
студентам	studentam	student am	student
субботу	subbotu	subbot u	subbot
суд	sud	sud	Sudan
Судане	Sudane	Sudan e	sudan
суданским	sudanskim	sudan sk im	sud
судов	sudov	sud ov	sud
судоходной	sudohodnoy	sud o hod n oy	hod
судя	sudya	sud ya	sud
суровые	surovyye	surov yye	surov
сухое	suhoye	suh oye	suh
Сухом	Suhom	Suh om	Suh
сухопутные	suhoputnyye	suh o put n yye	suh put
сформирована	sformirovana	s form ir ova n a	form
сфотографировал	sfotografiroval	s foto graf ir ova l	foto graf
схода	shoda	s hod a	hod
сходит	shodit	s hod it	hod
сходом	shodom	s hod om	hod
Счастливые	Schastlivyye	Schast liv yye	Schast
счет	schet	s chet	chet
счёт	schot	s chot	chot
считался	schitalsya	schit a l sya	schit
считаю	schitayu	schit a yu	schit
считают	schitayut	schit a yut	schit
считаются	schitayutsya	schit a yut sya	schit
Таиланда	Tailanda	Tailand a	Tailand
тайной	taynoy	tay n oy	tay
тайским	tayskim	tay sk im	tay
тайфуна	tayfuna	tayfun a	tayfun
такие	takiye	tak iye	tak
Такого	Takogo	Tak ogo	Tak
такое	takoye	tak oye	tak
таком	takom	tak om	tak
такси	taksi	taksi	taksi
Татарстана	Tatarstana	Tatarstan a	Tatarstan
Татарстане	Tatarstane	Tatarstan e	Tatarstan
тающего	tayuschego	ta yusch ego	ta
тела	tela	tel a	tel
телеканал	telekanal	tele kanal	tele kanal
телеканала	telekanala	tele kanal a	tele kanal
тема	tema	tem a	tem
темное	temnoye	tem n oye	tem
температура	temperatura	temperatur a	temperatur
температуры	temperatury	temperatur y	temperatur
темы	temy	tem y	tem
теоретически	teoreticheski	teor et ichesk i	teor
теракт	terakt	ter akt	ter akt
терактах	teraktah	ter akt ah	ter akt
терактом	teraktom	ter akt om	ter akt
территорией	territoriyey	territori yey	territori
территорию	territoriyu	territori yu	territori
террорист	terrorist	terror ist	terror
террористам	terroristam	terror ist am	terror
теряют	teryayut	ter ya yut	ter
техника	tehnika	tehn ik a	tehn
Тёплый	Toplyy	Topl yy	Topl
типичная	tipichnaya	tip ichn aya	tip
тифа	tifa	tif a	tif
тифом	tifom	tif om	tif
Тихого	Tihogo	Tih ogo	Tih
Тихом	Tihom	Tih om	Tih
того	togo	t ogo	t ogo
тока	toka	tok a	tok
толерантен	toleranten	tolerant en	tolerant
толком	tolkom	tolk om	tolk
толчки	tolchki	tol<ch> k i	tol<ch>
толчок	tolchok	tol<ch> ok	tol<ch>
Только	Tol'ko	Tol'ko	Tol'ko
тонн	tonn	tonn	tonn
тоннами	tonnami	tonn ami	tonnel
тоннеле	tonnele	tonnel e	tonnel
тот	tot	tot	tot
точке	tochke	tochk e	tochk
трагедия	tragediya	trag edi ya	trag
трагедия	tragicheskiye	trag ichesk iye	trag
траекторию	trayektoriyu	trayektori yu	trayektori
транспорта	transporta	transport a	transport
трансформации	transformatsii	transform atsi i	transform
трассах	trassah	trass ah	trass
требовалось	trebovalos'	treb ova l o s'	treb
требуют	trebuyut	treb u yut	treb
третью	tret'yu	tr et' yu	tr
троллейбусами	trolleybusami	trolley bus ami	trolley bus
тропический	tropicheskiy	tropi<ch> esk iy	tropi<ch>
тропической	tropicheskoy	tropi<ch> esk oy	tropi<ch>
тротуары	trotuary	trotuar y	trotuar
трудности	trudnosti	trudn ost i	trudn
тряски	tryaski	tryas k i	tryas
туда	tuda	tuda	Turets
Турецкие	Turetskiye	Turets k iye	tur
туротрасли	turotrasli	tur ot ras l i	ras
Турция	Turtsiya	Tur ts iya	Tur
Тут	Tut	Tut	Tut
тыловых	tylovyh	tyl ov yh	tyl
тысячам	tysyacham	tysyach am	tysyach
Тысячи	Tysyachi	Tysyach i	Tysyach
тяжелой	tyazheloy	tya<zh> el oy	tya<zh>
тяжелые	tyazhelyye	tya<zh> el yye	tya<zh>
убить	ubit'	ubi t'	ubi
увеличении	uvelichenii	u veli<ch> eni i	veli<ch>
увеличению	uvelicheniyu	u veli<ch> eni yu	veli<ch>
увеличенная	uvelichennaya	u veli<ch> enn aya	veli<ch>
увеличилась	uvelichilas'	u veli<ch> i l a s'	veli<ch>
уверен	uveren	u ver en	ver
уверенности	uverennosti	u ver enn ost i	ver
уверяют	uveryayut	u ver ya yut	ver
угодий	ugodiy	ugod iy	ugod
удается	udayetsya	uda yet sya	uda
ударная	udarnaya	udar n aya	udar
уезде	uyezde	uyezd e	uyezd
уже	uzhe	uzhe	uzhe
узнав	uznav	u zna v	zna
узнавали	uznavali	u zna v a l i	zna
указанному	ukazannomu	ukaz a nn omu	ukaz
Украинский	Ukrainskiy	Ukrain sk iy	Ukrain
украинцы	ukraintsy	ukrain ts y	ukrain
укрепленных	ukreplennyh	u krepl enn yh	krepl
укрылись	ukrylis'	u kry l i s'	kry
улиц	ulits	ulits	ulits
улица	ulitsa	ulits a	ulits
улицах	ulitsah	ulits ah	ulits
улыбнулась	ulybnulas'	ulyb nu l a s'	ulyb
умирают	umirayut	u mir a yut	mir
унесла	unesla	u nes l a	nes
унесли	unesli	u nes l i	nes
унеся	unesya	u nes ya	nes
универов	univerov	univer ov	univer
Университета	Universiteta	Universitet a	Universitet
уничтожено	unichtozheno	u nichtozh en o	nichtozh
уничтожила	unichtozhila	u nichtozh i l a	nichtozh
упомянутой	upomyanutoy	u pomya nu t oy	pomya
употребляли	upotreblyali	u potrebl ya l i	potrebl
Управлении	Upravlenii	U pravl eni i	pravl
ураганным	uragannym	uragan n ym	uragan
ураганом	uraganom	uragan om	uragan
уровне	urovne	u rovn e	rovn
уровни	urovni	u rovn i	rovn
уровня	urovnya	u rovn ya	rovn
Уроки	Uroki	Urok i	Urok
усилит	usilit	u sil it	sil
условие	usloviye	uslov i ye	uslov
условий	usloviy	uslov i y	uslov
условиями	usloviyami	uslov i yami	uslov
условиях	usloviyah	uslov i yah	uslov
услышал	uslyshal	u slysh a l	slysh
успел	uspel	uspe l	uspe
успешно	uspeshno	uspe <sh> n o	uspe
успешных	uspeshnyh	uspe <sh> n yh	uspe
установки	ustanovki	u stanov k i	stanov
утонувшего	utonuvshego	u to nu vsh ego	to
утопающих	utopayuschih	u top a yusch ih	top
уточняются	utochnyayutsya	u tochn ya yut sya	tochn
утра	utra	utr a	utr
ухудшения	uhudsheniya	u hudsh eni ya	hudsh
участием	uchastiyem	uchast i yem	uchast
ученым	uchenym	uch en ym	uch
учредителем	uchreditelem	uchred i tel em	uchred
ущерб	uscherb	uscherb	uscherb
фазовый	fazovyy	faz ov yy	faz
факт	fakt	fakt	fakt
Фашизм	Fashizm	Fash izm	Fash
февраля	fevralya	fevral ya	fevral
федеральных	federal'nyh	feder al'n yh	feder
фейерверков	feyyerverkov	feyyerverk ov	feyyerverk
физики	fiziki	fiz ik i	fiz
физические	fizicheskiye	fiz i<ch> esk iye	fiz
Физический	Fizicheskiy	Fiz i<ch> esk iy	Fiz
Филиппинах	Filippinah	Filippin ah	Filippin
фирма	firma	firm a	firm
фирмы	firmy	firm y	firm
Флориде	Floride	Florid e	Florid
фонда	fonda	fond a	fond
формах	formah	form ah	form
формируют	formiruyut	form ir u yut	form
фотографии	fotografii	foto graf i i	foto graf
Фотографии	Fotografii	Foto graf i i	Foto graf
фотографиях	fotografiyah	foto graf i yah	foto graf
Франции	Frantsii	Frants i i	Frants
футбольном	futbol'nom	fut bol' n om	fut bol'
Хабаровский	Habarovskiy	Habarov sk iy	Habarov
Хабаровского	Habarovskogo	Habarov sk ogo	Habarov
характер	harakter	harakter	harakter
характера	haraktera	harakter a	harakter
характерно	harakterno	harakter n o	harakter
хлоркой	hlorkoy	hlor k oy	hlor
ходе	hode	hod e	hod
хозяин	hozyain	hozya in	hozya
хозяина	hozyaina	hozya in a	hozya
хозяйственных	hozyaystvennyh	hozyay stv enn yh	hozyay
хоккею	hokkeyu	hokke yu	hokke
холодным	holodnym	holod n ym	holod
хотел	hotel	hot e l	hot
хотя	hotya	hotya	hotya
хотят	hotyat	hot yat	hot
храм	hram	hram	hram
хуже	huzhe	hu<zh> e	hu<zh>
целый	tselyy	tsel yy	tsel
Центральной	Tsentral'noy	Tsentr al'n oy	Tsentr
центре	tsentre	tsentr e	tsentr
циклоны	tsiklony	tsiklon y	tsiklon
цифру	tsifru	tsifr u	tsifr
частицы	chastitsy	chast its y	chast
частные	chastnyye	chast n yye	chast
частным	chastnym	chast n ym	chast
часть	chast'	chast'	chast'
Чаще	Chasche	Cha<sch> e	Cha<sch>
человек	chelovek	chelovek	chelovek
чемоданах	chemodanah	chemodan ah	chemodan
чемпионата	chempionata	chempion at a	chempion
четверг	chetverg	chetverg	chetverg
Четвертый	Chetvertyy	Chet v ert yy	Chet
чешские	cheshskiye	chesh sk iye	chesh
чёрная	chornaya	chorn aya	chorn
чилийским	chiliyskim	chiliy sk im	chiliy
чиновниками	chinovnikami	chin ov nik ami	chin
численности	chislennosti	chisl enn ost i	chisl
числятся	chislyatsya	chisl yat sya	chisl
чистое	chistoye	chist oye	chist
Читайте	Chitayte	Chit a y te	Chit
члена	chlena	chlen a	chlen
чрезвычайной	chrezvychaynoy	chrezvychay n oy	chrezvychay
чрезвычайных	chrezvychaynyh	chrezvychay n yh	chrezvychay
чрезмерного	chrezmernogo	chrez mer n ogo	mer
чувствовал	chuvstvoval	chu v stv ova l	chu
чужую	chuzhuyu	chuzh uyu	chuzh
шара	shara	shar a	shar
Швейцарию	Shveytsariyu	Shveytsar i yu	Shveytsar
шестерых	shesteryh	shest er yh	shest
шесть	shest'	shest'	shest'
шинелей	shineley	shinel ey	shinel
школьников	shkol'nikov	shkol' nik ov	shkol'
шла	shla	sh l a	sh
шпиль	shpil'	shpil'	shpil'
шпиля	shpilya	shpil ya	shpil
штатах	shtatah	shtat ah	shtat
штатов	shtatov	shtat ov	shtat
шторма	shtorma	shtorm a	shtorm
штормовая	shtormovaya	shtorm ov aya	shtorm
штормовым	shtormovym	shtorm ov ym	shtorm
эвакуация	evakuatsiya	evaku atsi ya	evaku
эвакуировали	evakuirovali	evaku ir ova l i	evaku
эвакуируют	evakuiruyut	evaku ir u yut	evaku
эквиваленте	ekvivalente	ekvivalent e	ekvivalent
эксперименте	eksperimente	eksperiment e	eksperiment
эксперты	eksperty	ekspert y	ekspert
экстерриториальный	eksterritorial'nyy	eks territori al'n yy	territori
экстренно	ekstrenno	ekstrenn o	ekstrenn
экстренной	ekstrennoy	ekstrenn oy	ekstrenn
экстренную	ekstrennuyu	ekstrenn uyu	ekstrenn
электропроводка	elektroprovodka	elektr o pro vod k a	elektr vod
электроэнергии	elektroenergii	elektr o energ i i	elektr energ
энергию	energiyu	energ i yu	energ
эпидемии	epidemii	epidem i i	epidem
Эпидемиологи	Epidemiologi	Epidemi o log i	Epidemi log
эпидемическим	epidemicheskim	epidem ichesk im	epidem
эпидемических	epidemicheskih	epidem ichesk ih	epidem
Эпидемия	Epidemiya	Epidem i ya	Epidem
эпизодами	epizodami	epizod ami	epizod
эпицентра	epitsentra	epi tsentr a	epi tsentr
Эритрее	Eritreye	Eritre ye	Eritre
Эстонии	Estonii	Eston i i	Eston
этаже	etazhe	etazh e	etazh
этажкам	etazhkam	etazh k am	etazh
этажке	etazhke	etazh k e	etazh
этап	etap	etap	etap
этапах	etapah	etap ah	etap
этапе	etape	etap e	etap
этими	etimi	et imi	et
Эфиопии	Efiopii	Efiop i i	Efiop
эффект	effekt	effekt	effekt
юга	yuga	yug a	yug
южных	yuzhnyh	yu<zh> n yh	yu<zh>
явились	yavilis'	yav i l i s'	yav
явлением	yavleniyem	yavl eni yem	yavl
ядерной	yadernoy	yader n oy	yader
Якутии	Yakutii	Yakut i i	Yakut
январе	yanvare	yanvar e	yanvar
января	yanvarya	yanvar ya	yanvar
