token	segmentation
aadɛn	a adɛn
Aane	Aane
Aba	A ba
abakɔsɛm	abakɔ sɛm
aban	aban
abatoɔ	aba toɔ
abɛbrɛ	a bɛ brɛ
abɛdum	a bɛ dum
abɛduru	abɛ duru
abɛfa	a bɛ fa
Abɛfra	A bɛ fra
abɛgu	a bɛ gu
abɛgugu	a bɛ gu gu
abɛgya	a bɛ gya
abɛgye	a bɛ gye
abɛgyina	a bɛ gyina
abɛka	a bɛ ka
abɛkasa	a bɛ kasa
abɛkyerɛ	a bɛ kyerɛ
abɛma	a bɛ ma
abene	a bene
abɛpue	a bɛ pue
aberɛ	a berɛ
abɛsi	a bɛ si
abɛtena	a bɛ tena
abɛtie	a bɛ tie
abɛtoa	a bɛ toa
abɛtoto	a bɛ toto
abɛtwetwe	a bɛ twe twe
abɛyɛ	a bɛ yɛ
aboa	a boa
abɔ	a bɔ
abobɔ	a bobɔ
abom	a bom
abɔntene	abɔntene
aboɔ	a boɔ
aboro	a boro
aborɔ	a borɔ
abɔsoɔ	a bɔ soɔ
abotare	abotare
aboterɛ	aboterɛ
abrabɔ	abrabɔ
abre	a bre
abrɛ	a brɛ
abrewa	abrewa
Abu	A bu
abue	a bue
abufuo	a bufu o
abusuafoɔ	abusua foɔ
abutu	a butu
ada	a da
adaagye	adaagye
adan	a dan
Adankra	Adankra
Adankranya	Adankra nya
adansefoɔ	a danse foɔ
Adansi	A dan si
adaworoma	adaworoma
ade	ade
adebɔne	ade bɔne
adeɛ	a deɛ
adehyɛ	ade hyɛ
adehyeɛ	ade hye ɛ
adekorɔ	ade korɔ
adekye	adekye
adɛn	a dɛn
Adɛn	A dɛn
adesua	adesua
adi	a di
adidi	a di di
Adom	Adom
adorɔbafoɔ	ado rɔ ba foɔ
adu	a du
aduane	a duane
aduasa	a duasa
adum	a dum
aduonu	aduo nu
aduonum	aduo num
aduro	a duro
aduru	a duru
adwadie	a dwa die
adwane	a dwane
adwene	a dwene
adworoma	adworoma
adwuma	a dwuma
adwumanom	a dwuma nom
adze	adze
adzepa	adze pa
afa	a fa
Afe	A fe
afenaa	a fenaa
afena	a fena
afidie	a fidie
Afiri	A firi
afom	a fom
afoum	a foum
afu	a fu
agorɔ	agorɔ
agu	a gu
aguo	a gu o
agya	a gya
agyae	a gya e
Agye	A gye
agyina	a gyina
aha	a ha
ahe	ahe
Ahenkora	Ahen kora
ahia	a hia
ahoboa	ahoboa
ahodoɔ	ahodoɔ
ahohoro	aho horo
ahonnidie	ahonni die
ahotɔ	ahotɔ
ahunu	a hu nu
ahwie	a hwi e
ahye	a hye
ahyɛ	a hyɛ
ahyia	a hyia
Aka	A ka
akakyerɛ	a ka kyerɛ
akan	akan
akasa	a kasa
akeka	a ke ka
akɛseɛ	a kɛse ɛ
akoa	a koa
ako	a ko
akɔ	a kɔ
akɔda	a kɔ da
akɔdi	a kɔ di
akɔfa	a kɔ fa
akɔgu	a kɔ gu
akɔgye	a kɔ gye
akɔgyegye	a kɔ gye gye
akɔhwɛ	a kɔ hwɛ
akɔhyia	a kɔ hyia
akɔkasa	a kɔ kasa
akokoduro	akoko duro
akokoɔduro	akokoɔ duro
akɔmfo	a kɔm fo
akɔneaba	akɔne a ba
akɔnnɔ	a kɔnnɔ
akontaabuo	akontaa buo
akɔsi	a kɔ si
akɔso	a kɔ so
akɔtena	a kɔ tena
akɔtɔ	a kɔ tɔ
akɔtwa	a kɔ twa
akɔyɛ	a kɔ yɛ
aku	a ku
Akufo	Akufo
Akum	A kum
akwaaba	akwaaba
Akwamuhene	Akwamu hene
akwan	a kwan
akwanhyia	akwan hyia
akwanya	akwan ya
akye	a kye
akyɛ	a kyɛ
akyeakyea	a kyea kyea
akyerɛ	a kyerɛ
akyɛw	a kyɛw
akyi	a kyi
akyire	a kyire
akyiri	a kyiri
akyitafoɔ	a kyita foɔ
Ama	A ma
amafoɔ	ama foɔ
amammerɛ	a ma m <m>erɛ
amammou	a ma m <m>ou
amammuo	a ma m <m>uo
aman	a man
amanfoɔ	a man foɔ
amanhodoɔ	a man hodoɔ
amannebɔfoɔ	amanne bɔ foɔ
amannebɔni	amanne bɔ ni
amanneɛ	amanneɛ
amannwɔkuo	a mannwɔ kuo
amansan	a man san
amanwaɔkuo	a manwaɔ kuo
amanwɔkuo	a manwɔ kuo
amanyɔ	a manyɔ
amanyɔkuo	amanyɔ kuo
amanyɔsɛm	amanyɔ sɛm
amfa	a m fa
amma	a m <m>a
ammɛ	a m <m>ɛ
ammene	a m <m>ene
ammɛsuma	a m<m>ɛ suma
ammoa	a m <m>oa
ampa	a mpa
Amuni	A muni
anaa	anaa
Anaasɛ	Anaa sɛ
anadwo	anadwo
anammɔn	anammɔn
anan	a nan
ananneɛ	a nan neɛ
anasɛ	ana sɛ
ane	a ne
Anha	A n ha
ani	ani
anidasoɔ	anida soɔ
anigyesɛm	anigye sɛm
anika	anika
anim	a nim
ankaa	ankaa
anka	a n ka
ankasa	a n kasa
ankɔ	a n kɔ
ankɔyɛ	a n kɔ yɛ
ankyerɛ	a n kyerɛ
anna	a n <n>a
anni	a n <n>i
annya	a n <n>ya
ano	ano
Anokye	Anokye
anom	a nom
anoɔden	anoɔ den
Anɔpa	Anɔpa
ansa	a nsa
ansan	a n san
ansane	a n sane
anum	a num
anwummerɛ	a nwu m <m>erɛ
Anya	A n ya
anyanyam	a n yanyam
anyɛ	a n yɛ
anyi	a n yi
apa	a pa
apaapae	a paa pae
apampam	a pam pam
apansam	a pan sam
apata	a pata
apɛ	a pɛ
Apirapira	A pira pira
apɔ	a pɔ
apolisifoɔ	a polisi foɔ
apoɔdeɛ	apoɔ deɛ
aporɔ	a porɔ
aporɔbɔ	a porɔ bɔ
aprɔ	a prɔ
apue	a pue
ara	ara
asan	a san
asane	a sane
asase	asase
ase	a se
asɛ	a sɛ
asɛdeɛ	asɛ deɛ
asɛe	a sɛe
aseɛ	a seɛ
asɛm	a sɛm
asesa	a sesa
asi	a si
asie	a si e
asiesie	a sie sie
asoa	a soa
asɔ	a sɔ
asomasi	asoma si
asomdwoe	asomdwoe
asomdwoeɛ	asomdwoeɛ
asɔre	a sɔre
asorɔkyee	a sorɔ kye e
asoso	a so so
asuae	a sua e
ataa	ataa
ataadeɛ	ataa deɛ
atadeɛ	ata deɛ
atae	a tae
Ate	A te
atena	a tena
atese	a te se
atete	a te te
atia	a tia
atikyafoɔ	a tikya foɔ
atim	a tim
atiridii	a tiridii
atoa	a toa
ato	a to
atɔ	a tɔ
Atɔeɛ	A tɔ eɛ
atofodeɛ	atofo deɛ
atom	a tom
atomuɔ	a tomu ɔ
atɔn	a tɔn
atonko	a to nko
Atonsu	A to nsu
atotɔ	a to tɔ
atotototo	a toto toto
Atu	A tu
atumi	a tumi
atwa	a twa
atwam	a twam
atwe	a twe
atwitwam	a twitwam
aware	a ware
awerɛhosɛm	awerɛho sɛm
awia	awia
awie	a wie
awɔ	a wɔ
Awofoɔ	Awo foɔ
awoɔ	a woɔ
awu	a wu
Awudifoɔ	Awudi foɔ
Awuni	Awu ni
awura	a wura
ayamtuo	a yam tuo
ayɛ	a yɛ
ayera	a yera
Ayere	A yere
ayereso	a yere so
ayi	a yi
ayie	a yie
ayifoɔ	ayi foɔ
Baa	Ba a
baabi	baabi
Baako	Baako
ba	ba
badwakuo	badwa kuo
badwani	badwa ni
bae	ba e
baeɛ	ba eɛ
bammɔ	ba m <m>ɔ
bankye	bankye
Bawkufoɔ	Bawku foɔ
bɛba	bɛ ba
Bɛ	Bɛ
bɛbisa	bɛ bisa
bɛboa	bɛ boa
bɛbɔ	bɛ bɔ
bɛbrɛ	bɛ brɛ
bebree	bebree
bɛbu	bɛ bu
bɛbuebue	bɛ bue bue
bɛdi	bɛ di
bɛduru	bɛ duru
bɛɛ	bɛ ɛ
bɛfa	bɛ fa
bɛgyaa	bɛ gya a
bɛgye	bɛ gye
bɛgyina	bɛ gyina
bɛhunu	bɛ hu nu
bɛhwɛɛ	bɛ hwɛ ɛ
bɛhwɛeɛ	bɛ hwɛ eɛ
bɛhyɛɛ	bɛ hyɛ ɛ
bɛka	bɛ ka
bɛkan	bɛ kan
bɛkɔ	bɛ kɔ
Bekwaifoɔ	Bekwai foɔ
bɛkyerɛkyerɛɛ	bɛ kyerɛ kyerɛ ɛ
bɛmene	bɛ me ne
bɛmia	bɛ mia
bɛn	bɛn
bɛnya	bɛ nya
bɛpue	bɛ pue
berɛ	berɛ
bɛsane	bɛ sane
bɛsi	bɛ si
bɛte	bɛ te
bɛto	bɛ to
bɛtɔ	bɛ tɔ
bɛtoo	bɛ too
bɛtoɔ	bɛ toɔ
bɛtuatua	bɛ tua tua
bɛtumi	bɛ tumi
bɛweene	bɛ weene
bewia	be wia
bɛwu	bɛ wu
bɛwuraa	bɛ wura a
Bɛyɛ	Bɛ yɛ
bɛyɛɛ	bɛ yɛ ɛ
bia	bia
biara	biara
bi	bi
bibiara	bi biara
bie	bie
bini	bi ni
binomakɔdi	bi nom a kɔ di
binom	bi nom
bio	bio
biom	bio m
biribiara	biri biara
biribi	biri bi
bisaa	bisa a
bisa	bisa
boa	boa
bo	bo
bɔ	bɔ
bɔbɔɔbɔ	bɔbɔɔbɔ
bodweabodwea	bodwea bodwea
bɔkɔɔ	bɔkɔ ɔ
bom	bom
bɔn	bɔn
bɔne	bɔne
bɔnefoɔ	bɔne foɔ
Bono	Bo no
bɔɔ	bɔ ɔ
bɔɔla	bɔɔla
bɔɔlasɛm	bɔɔla sɛm
borɔ	borɔ
Borɔfo	Borɔ fo
borɔno	borɔ no
bosom	bosom
bosome	bosome
braa	bra a
bra	bra
brɛ	brɛ
butubutu	butu butu
cedi	cedi
Cedis	Cedis
daabi	daabi
daa	da a
daakye	daakye
dabiara	da biara
Da	Da
dadaada	da daa da
dada	da da
daduani	da duani
dadwene	da dwene
Dan	Dan
dane	dane
dasani	dasa ni
dea	de a
deda	deda
de	de
dɛ	dɛ
deɛbɛn	deɛ bɛn
deɛ	de ɛ
dɛɛ	dɛ ɛ
Deɛn	Deɛn
dɛm	dɛm
den	den
dɛn	dɛn
dene	dene
dɛw	dɛw
di	di
die	die
dii	di i
din	din
do	do
dɔ	dɔ
dodoɔ	dodo ɔ
dɔkonona	dɔkono na
dɔm	dɔm
dɔmpem	dɔm pem
dɔnhwere	dɔn hwere
dua	dua
dumsɔ	dum sɔ
duru	duru
duruu	duru u
dwa	dwa
dwam	dwam
dwennwenee	dwen n wene e
dwonsɔ	dwon sɔ
dwumadie	dwuma die
dwuma	dwuma
dwumedzi	dwume dzi
ɛbaa	ɛ ba a
Ɛbabɛduruu	Ɛ ba bɛ duru u
ɛba	ɛ ba
ɛbɛba	ɛ bɛ ba
ɛbɛboa	ɛ bɛ boa
ɛbɛduru	ɛ bɛ duru
ɛbɛ	ɛ bɛ
Ɛbɛ	Ɛ bɛ
ɛbɛɛyɛ	ɛ bɛ ɛ yɛ
ɛbɛfiri	ɛ bɛ firi
ɛbɛhia	ɛ bɛ hia
ɛbɛhye	ɛ bɛ hye
ɛbɛkɔso	ɛ bɛ kɔ so
ɛbɛkye	ɛ bɛ kye
ɛbɛkyerɛ	ɛ bɛ kyerɛ
ɛbɛma	ɛ bɛ ma
ɛbɛnya	ɛ bɛ nya
ɛbɛpue	ɛ bɛ pue
ɛberɛ	ɛ berɛ
Ɛberɛ	Ɛ berɛ
ɛbɛtee	ɛ bɛ te e
ɛbɛto	ɛ bɛ to
ɛbɛtu	ɛ bɛ tu
ɛbɛtumi	ɛ bɛ tumi
ɛbɛtwa	ɛ bɛ twa
ɛbɛtwetwe	ɛ bɛ twe twe
ɛbɛyɛ	ɛ bɛ yɛ
ɛbɛyi	ɛ bɛ yi
ɛbia	ɛ bia
Ɛbia	Ɛ bia
Ebi	E bi
ɛbi	ɛ bi
ɛbifiri	ɛ bi firi
Ebinom	E binom
ɛboa	ɛ boa
ɛboaeɛ	ɛ boa eɛ
ɛbɔn	ɛ bɔn
ɛboɔ	ɛ boɔ
ɛboro	ɛ boro
Ebu	E bu
ɛda	ɛ da
Ɛda	Ɛ da
ɛdan	ɛ dan
ɛde	ɛ de
Ɛde	Ɛ de
ɛdeɛn	ɛ deɛn
edi	e di
ɛdi	ɛ di
ɛdɔ	ɛ dɔ
ɛdɔm	ɛ dɔm
ɛdɔɔso	ɛ dɔɔso
edu	e du
Ɛdu	Ɛ du
eduru	e duru
ɛduru	ɛ duru
ɛdwada	ɛ dwa da
edwa	e dwa
ɛdwa	ɛ dwa
Ɛdwoada	Ɛdwoada
ɛɛhoo	ɛ ɛhoo
ɛfa	ɛ fa
efie	e fie
efi	e fi
efii	e fii
ɛfiri	ɛ firi
Ɛfiri	Ɛ firi
ɛfirii	ɛ firi i
Ɛfirii	Ɛ firi i
ɛfoforɔ	ɛ foforɔ
egu	e gu
ɛgu	ɛ gu
ɛgum	ɛ gum
ɛguu	ɛ gu u
egya	e gya
ɛgye	ɛ gye
ɛgyina	ɛ gyina
Ɛha	Ɛ ha
ɛhanom	ɛ ha nom
ɛhare	ɛ hare
ɛhaw	ɛ haw
Ɛhefa	Ɛ hefa
ehia	e hia
ɛho	ɛ ho
Ɛho	Ɛ ho
ɛhɔ	ɛ hɔ
ɛhɔnom	ɛ hɔ nom
ɛhu	ɛ hu
Ɛhwɛɛ	Ɛ hwɛ ɛ
ɛhyɛ	ɛ hyɛ
ɛkaa	ɛ ka a
Ɛkaa	Ɛ ka a
ɛka	ɛ ka
ɛkakra	ɛ ka kra
ɛkasa	ɛ kasa
ɛkɔbaa	ɛ kɔ ba a
Ɛkɔba	Ɛ kɔ ba
Ɛkɔbɔɔ	Ɛ kɔ bɔ ɔ
ɛkɔeɛ	ɛ kɔ eɛ
ɛkɔ	ɛ kɔ
ɛkɔɔ	ɛ kɔ ɔ
ɛkorɔ	ɛ korɔ
ɛkɔsiiɛ	ɛ kɔ si i ɛ
ɛkum	ɛ kum
ɛkuo	ɛ kuo
ekuro	e kuro
ɛkwan	ɛ kwan
Ɛkwan	Ɛ kwan
ɛkyɛ	ɛ kyɛ
Ɛkyɛ	Ɛ kyɛ
ɛkyerɛɛ	ɛ kyerɛ ɛ
ɛkyerɛ	ɛ kyerɛ
Ɛmaa	Ɛ ma a
ɛma	ɛ ma
Ɛma	Ɛ ma
ɛman	ɛ man
ɛmene	ɛ mene
ɛmfa	ɛ  m fa
Ɛmfa	Ɛ m fa
ɛmmaa	ɛ  m <m>a a
ɛmma	ɛ m <m>a
Ɛmma	Ɛ m <m>a
ɛmmɛhye	ɛ m <m>ɛ hye
Ɛmmerɛ	Ɛ m <m>erɛ
ɛmmoa	ɛ m <m>oa
ɛmo	ɛ mo
ɛmpoano	ɛ mpoano
ɛmpo	ɛ mpo
ɛmsɛ	ɛ m sɛ
ɛmu	ɛ mu
ɛna	ɛ na
Ɛna	Ɛ na
ɛnam	ɛ nam
Ɛnam	Ɛ nam
Ɛneɛ	Ɛ ne ɛ
ɛne	ɛ ne
Ɛne	Ɛ ne
ɛnɛ	ɛ nɛ
ɛnhiaa	ɛ n hia a
ɛnie	ɛ ni e
ɛnkɔ	ɛ n kɔ
ɛnna	ɛ n na
ɛnneɛ	ɛ nne ɛ
Ɛnneɛ	Ɛ n ne ɛ
ɛnne	ɛ n ne
ɛnnɛ	ɛ n nɛ
Ɛnnɛ	Ɛ n nɛ
ɛnnim	ɛ n nim
ɛnnya	ɛ n <n>ya
ɛnnyɛ	ɛ <n>nyɛ
ɛno	ɛ no
Ɛno	Ɛ no
ɛnɔ	ɛ nɔ
ɛnɔnɔ	ɛ nɔ nɔ
ɛnsɛ	ɛ n sɛ
Ɛnsia	Ɛ nsia
Ɛnso	Ɛ n so
ɛnsɔ	ɛ n sɔ
ɛnte	ɛ n te
Ɛnte	Ɛ n te
ɛntena	ɛ n tena
entia	e n tia
Enti	E nti
ɛnti	ɛ nti
ɛntumi	ɛ n tumi
ɛnum	ɛ num
Ɛnum	Ɛ num
enya	e n ya
ɛnya	ɛ n ya
ɛnyam	ɛ n yam
enyan	e n yan
ɛnyɛɛ	ɛ  n yɛ ɛ 
ɛnyɛ	ɛ n yɛ
Ɛnyɛ	Ɛ n yɛ 
ɛpɛ	ɛ pɛ
ɛpepapepaa	ɛ pepa pepa a
ɛperepereeɛ	ɛ pere pere eɛ
ɛreba	ɛ re ba
ɛrebatwam	ɛ re ba twam
ɛrebɛba	ɛ re bɛ ba
Ɛrebɛdi	Ɛ re bɛ di
ɛrebɛ	ɛ re bɛ
ɛrebɛkɔ	ɛ re bɛ kɔ
ɛrebobɔ	ɛ re bo bɔ
ɛredi	ɛ re di
ɛreha	ɛ re ha
ɛrehyehye	ɛ re hye hye
ɛrekakyerɛ	ɛ re ka kyerɛ
ɛrekame	ɛ re ka me
ɛreko	ɛ re ko
ɛrekɔ	ɛ re kɔ
ɛrekɔso	ɛ re kɔ so
ɛrekɔyɛ	ɛ re kɔ yɛ
ɛremene	ɛ re mene
ɛrepɛ	ɛ re pɛ
ɛresa	ɛ re sa
ɛresɛe	ɛ re sɛ e
ɛresisi	ɛ re si si
ɛreumpo	ɛ re u mpo
ɛreyɛ	ɛ re yɛ
ɛreyi	ɛ re yi
ɛsɛ	ɛ sɛ
Ɛsɛ	Ɛ sɛ
ɛsesa	ɛ sesa
ɛsiane	ɛ siane
Ɛsiane	Ɛ siane
ɛsi	ɛ si
ɛsiiɛ	ɛ sii ɛ
ɛsii	ɛ si i
ɛsoa	ɛ soa
ɛso	ɛ so
ɛsua	ɛ sua
ɛsum	ɛ sum
ɛtaa	ɛ ta a
ɛteɛ	ɛ te ɛ
ɛte	ɛ te
ɛto	ɛ to
ɛtɔ	ɛ tɔ
Ɛtɔ	Ɛ tɔ
ɛtoo	ɛ to o
ɛtoɔ	ɛ toɔ
ɛtoto	ɛ to to
ɛtua	ɛ tua
ɛtumi	ɛ tumi
ɛtwa	ɛ twa
ɛtwene	ɛ twene
ewiase	e wiase
ɛwɔ	ɛ wɔ
ɛwom	ɛ wom
Ɛwom	Ɛ wom
ewuiɛ	e wui ɛ
ɛyareɛ	ɛ yare ɛ
ɛyɛdɛ	ɛ yɛ dɛ
ɛyɛeɛ	ɛ yɛe ɛ
ɛyɛɛ	ɛ yɛ ɛ
Ɛyɛɛ	Ɛ yɛ ɛ
ɛyɛ	ɛ yɛ
Ɛyɛ	Ɛ yɛ
ɛyi	ɛ yi
faa	fa a
faeɛ	fa eɛ
fae	fa e
fa	fa
fam	fam
fann	fann
fɛfɛɛfɛ	fɛfɛ ɛ fɛ
fie	fie
fi	fi
firi	firi
firii	firi i
Fiti	Fiti
foforo	foforo
foɔ	fo ɔ
frɛɛ	frɛ ɛ
frɛ	frɛ
fuiɛ	fui ɛ
funtumfrae	funtum frae
funu	funu
Ghanafoɔ	Ghana foɔ
Ghanani	Ghana ni
gu	gu
gugu	gu gu
gyaa	gya a
gya	gya
gyee	gye e
gyeene	gyee ne
gye	gye
gyidie	gyidie
ha	ha
hanom	ha nom
hene	hene
hia	hia
ho	ho
hɔ	hɔ
honam	ho nam
hɔnom	hɔ nom
hoo	ho o
hu	hu
huhuuhu	hu huu hu
hunu	hu nu
hunuu	hu nu u
huri	huri
hwan	hwan
hwee	hwe e
hwɛɛ	hwɛ ɛ
Hwɛ	Hwɛ
hwehwɛɛ	hwe hwɛ ɛ
hwene	hwene
Hwidiem	Hwidiem
hwie	hwi e
Hwiitam	Hwiitam
hwirii	hwiri i
hyɛbrɛ	hyɛ brɛ
hyee	hye e
hyɛɛ	hyɛ ɛ
hyehyeehye	hye hye e hye
hyehye	hye hye
hyiaeɛ	hyia eɛ
kaaeɛ	ka a eɛ
Kaa	Ka a
kaakum	kaakum
kabimankabi	kabi man kabi
kaeɛ	ka eɛ
Ka	Ka
kakrakaa	ka kra ka a
kakraka	ka kra ka
kakra	kakra
kama	kama
kan	kan
kaprɛba	kaprɛ ba
kasa	kasa
kaseɛ	kase ɛ
keka	keka
kɛkɛ	kɛkɛ
kɛseɛ	kɛse ɛ
kɛse	kɛse
ketewa	ketewa
Kita	Kita
kɔduruu	kɔ duru u
kɔeɛ	kɔ eɛ
kɔgu	kɔ gu
kɔgyinaeɛ	kɔ gyinae ɛ
kɔhunuu	kɔ hunu u
kɔka	kɔ ka
ko	ko
kɔ	kɔ
kokɔkokɔɔ	kokɔkokɔɔ
kokroko	kokroko
kɔmaa	kɔ ma a
Komfo	Komfo
kɔn	kɔn
Koo	Koo
kɔɔ	kɔ ɔ
kɔɔto	kɔ ɔ to
koowa	koo wa
kɔpaa	kɔ pa a
kɔpuee	kɔ pue e
kɔpue	kɔ pue
koro	koro
korɔ	korɔ
koroyɛfoɔ	koroyɛ foɔ
kɔsi	kɔ si
kɔso	kɔ so
kɔtena	kɔ tena
kɔtɔɔ	kɔ tɔ ɔ
kɔtua	kɔ tua
kɔyɛɛ	kɔ yɛ ɛ
krakye	krakye
krataa	krataa
Kukuom	Kukuom
kunu	ku nu
kuo	kuo
kura	kura
kuro	kuro
kurom	kurom
kutafoɔ	kuta foɔ
Kwaku	Kwaku
kwa	kwa
Kwan	Kwan
kye	kye
kyɛ	kyɛ
kyena	kyena
kyerɛɛ	kyerɛ ɛ
Kyerɛ	Kyerɛ
kyerɛkyerɛɛ	kyerɛ kyerɛ ɛ
Kyɛw	Kyɛw
kyɛwne	kyɛw ne
kyinkyinaa	kyin kyin aa
maa	ma a
mabaa	ma ba a
Maba	Ma ba
mabɛhyɛ	ma bɛ hyɛ
mabɔ	ma bɔ
m'adamfo	m' adamfo
madi	ma di
madwene	ma dwene
m'adwuma	m' adwuma
mafa	ma fa
magye	ma gye
mahunu	ma hu nu
maka	ma ka
Makɔ	Ma kɔ
makɔsoa	ma kɔ soa
makɔtua	ma kɔ tua
ma	ma
mampanin	mam panin
manhunu	ma n hu nu
m'anigyeɛ	m'  anigye ɛ
m'ani	m' ani
m'anim	m' anim
manka	ma n ka
Mankasa	Ma n kasa
manpaninfoɔ	man panin foɔ
manpanin	man panin
mansane	man sane
mansini	man sini
Mantam	Man tam
mantumi	ma n tumi
Manyare	Ma n yare
mapa	ma pa
masa	ma sa
masane	ma sane
m'asɛm	m'  asɛm
mate	ma te
mato	ma to
mayɛ	ma yɛ
mayera	ma yera
mayi	ma yi
mebaa	me ba a
meba	me ba
Mebɛhunuu	Me bɛ hu nu u
mebɛkaa	me bɛ ka a
Mebisaa	Me bisa a
meboa	me boa 
mɛbɔ	mɛ bɔ
medaa	me da a
meda	me da
Medeɛ	Me de ɛ
Mede	Me de
Meduru	Me duru
Mee	Me e
mefaa	me fa a
Mɛfa	Mɛ fa
Meferɛɛ	Me ferɛ ɛ
mefiri	me firi
mefrɛɛ	me frɛ ɛ
mɛfrɛ	mɛ frɛ
mɛgyae	mɛ gya e
Megyedi	Me gye di
megye	me gye
megyinaeɛ	me gyinae ɛ
megyina	me gyina
mehunu	me hu nu
Mehunuu	Me hu nu u
mehwɛɛ	me hwɛ ɛ
mehwɛ	me hwɛ 
mehyɛ	me hyɛ
mekaa	me ka a
Meka	Me ka 
Mɛka	M ɛ ka
mekamfo	me kamfo
mekasaeɛ	me kasa eɛ
mekɔgyinaa	me kɔ gyina a
Mekɔhwɛɛ	Me kɔ hwɛ ɛ
mɛkɔ	mɛ kɔ
mekɔɔ	me kɔ ɔ
mekɔyɛɛ	me kɔ yɛ ɛ
Mekura	Me kura
Mɛkye	Mɛ kye 
mɛma	mɛ ma
me	me
memfa	me m fa
memma	me m <m>a
mempɛ	me m pɛ
menam	me nam
mene	me ne
menhunu	me n hunu
menii	me ni i
Menim	Me nim
menka	me n ka
menkura	me n kura
menni	me n <n>i
Mennim	Me n <n>im
mennye	me <n>nye
mennyɛ	me <n>nyɛ
Mentee	Me n te e
mente	me n te
Mentua	Me n tua
mentumi	me n tumi
mentwa	me n twa
menua	me nua
menuanom	me nua nom
menyaa	me n ya a
menya	me n ya
menyi	me n yi
menyin	me nyin
mepa	me pa
mepɛ	me pɛ
mepra	me pra
merebama	me re bama
mereba	me re ba
Merebisa	Me re bisa
meredwene	me re dwene
merekae	me re kae 
merekakyerɛ	me re ka kyerɛ
mereka	me re ka
merekɔ	me re kɔ
Merekyerɛ	Me re kyerɛ
merentumi	me re n tumi
merepam	me re pam
Meresan	Me re san
mereyɛ	me re yɛ
Mesane	Me sane
Mɛsane	Mɛ sane
mesee	me se e
mese	me se
mɛsrɛ	mɛ srɛ
mesuro	me suro
meteeɛ	me te eɛ
metee	me te e
meteɛ	me te ɛ
mete	me te
metua	me tua
mɛtua	mɛ tua
mɛtumi	mɛ tumi
metuu	me tu u
Mewiee	Me wie e
mewɔ	me wɔ
Meyɛ	Me yɛ
mɛyɛ	mɛ yɛ
mfaa	m fa a
mfa	m fa
mfasoɔ	mfasoɔ
mfeɛ	m fe ɛ
mfe	m fe
mfidie	m fidie
mfie	m fie
Mfimfini	Mfimfini
mfiri	m firi
mfomsoɔ	mfomsoɔ
mfonini	m fonini
Migye	Mi gye
mmaa	m <m>aa
mmabaawa	m <m>abaawa
mmabunu	m <m>abunu
mmae	m mae
mma	m <m>a
mmarahyɛbadwafie	mmara hyɛ badwa fie
mmarahyɛbadwa	mmara hyɛ badwa
mmarahyɛbadwani	mmara hyɛ badwa ni
mmarahyɛ	mmara hyɛ
mmara	mmara
Mmaranteɛ	M <m>arante ɛ
mmayewa	m <m>ayewa
mmeammea	mmea mmea
mmɛbobɔ	m <m>ɛ bo bɔ
mmɛkyerɛ	m<m>ɛ kyerɛ
mmɛmma	m <m>ɛmma
mmɛ	m<m>ɛ
mmenee	m<m>ene e
Mmeranteɛ	M <m>erante ɛ
Mmerɛ	M <m>erɛ
mmɛsii	m <m>ɛ si i
mmɛtena	m <m>ɛ tena
mmɛtɔ	m <m>ɛ tɔ
mmɛyɛeɛ	m <m>ɛ yɛ eɛ
mmɛyɛ	m <m>ɛ yɛ
mmiɛnsa	mmiɛnsa
mmienu	mmienu
mmirika	mmirika
mmoa	m <m>oa
mmɔbɔ	m<m>ɔ bɔ
mmɔden	m <m>ɔden
Mmom	Mmom
mmo	mmo
mmɔ	mmɔ
mmon	mmon
mmɔntene	m <m>ɔnten e
mmɔnten	m <m>ɔnten
mmɔtene	m <m>ɔtene
mmranteɛ	m <m>rante ɛ
mmrɛɛ	mmrɛ ɛ
moaba	mo a ba
moaduru	mo a duru
moahunu	mo a hunu
Moakɔ	Mo a kɔ
moba	mo ba
Mobɛtɔaa	Mo bɛ tɔ aa
mobɛtumi	mo bɛ tumi
modidie	mo di di e
mogu	mo gu
mohunu	mo hu nu
Mokae	Mo ka e
momma	mo m <m>a
mommoa	mo m<m>oa
mo	mo
monhunu	mo n hu nu
Monka	Mo n ka
Monkɔhwɛ	Mo n kɔ hwɛ
monkum	mo n kum
monni	mo n ni
monnyae	mo n <n>yae
montie	mo n tie
montumi	mo n tumi
Monyɛ	Mo n yɛ
mopɛ	mo pɛ
Moree	Mo re e
Morehwɛ	Mo re hwɛ
morekɔ	mo re kɔ
motua	mo tua
motumi	mo tumi
mowɔ	mo wɔ
Moyɛ	Mo yɛ
mpaeɛ	m pae ɛ
mpamo	m pamo
mpanimfoɔ	m panim foɔ
mpanin	m panin
mpasua	m pasua
mpɛ	m pɛ
mpɛn	m pɛn
mpɛnpɛnsoɔ	m pɛnpɛn soɔ
mpoa	m poa
mpo	mpo
mpɔn	m pɔn
mpɔtamu	mpɔ tamu
mpu	mpu
mu	mu
muna	muna
muo	mu o
Naa	Naa
n'abadiakyire	n' a badi a kyire
n'abatoɔ	n' a ba toɔ
n'abusuafoɔ	n' a busua foɔ
n'adeɛ	n' ade ɛ
n'adwene	n' adwene
n'adwuma	n' a dwuma
n'akyire	n' a kyire
n'amanyɔkuo	n' amanyɔ kuo
nam	nam
Na	Na
nana	nana
nananom	nana nom
n'anim	n' a nim
n'ani	n' ani
nankasa	n ankasa
n'ankasankasa	n' ankasa n kasa
nan	nan
n'ano	n'  ano
nanso	nanso
nantam	nan tam
nante	nante
n'aporɔbɔ	n' a porɔ bɔ
n'asɛdeɛ	n' a sɛ deɛ
n'ase	n' a se
n'aso	n' aso
n'ataadeɛ	n' ataadeɛ
n'ayi	n' ayi
Nea	Nea
nenam	ne nam
Ne	Ne
nɛ	nɛ
n'enyim	n' e nyim
neyɔeɛ	n eyɔ eɛ
nhunu	n hu nu
nhwehwɛmuahunu	n hwe hwɛ mua hu nu
nhwehwɛmu	n hwe hwɛ mu
nhyehyɛeɛ	n hye hyɛ eɛ
nhyɛ	n hyɛ
nie	nie
nimdeɛ	nimdeɛ
ni	ni
nipa	nipa
nisuo	nisuo
nkaa	n kaa
nkabom	nkabom
nkakra	n kakra
nkakrankakra	n kakra n kakra
nkanea	n kanea
nka	n ka
Nkankan	N kan kan
nkankɔ	n kankɔ
Nkawuramu	Nkawuramu
nketenkete	nkete nkete
nkoasom	n koa som
nkoden	n koden
nkɔgu	n kɔ gu
nkɔkorafoɔ	n kɔkora foɔ
nkɔma	n kɔ ma
nkɔmmɔɛna	nkɔmmɔ ɛna
nkɔmmɔ	nkɔmmɔ
nkɔm	n kɔm
nkonimdifoɔ	nkonim di foɔ
nkonim	nkonim
nko	n ko
nkɔ	n kɔ
nkontaa	n kontaa
nkɔraa	n kɔra a
nkorabata	n kora bata
nkɔto	n kɔ to
nkɔtɔ	n kɔ tɔ
Nkɔtua	N kɔ tua
nkɔyɛɛ	n kɔ yɛ ɛ
nkɔyɛ	n kɔ yɛ
Nkran	Nkran
Nkruma	Nkruma
nkunimdie	nkunim di e
nkunimdifoɔ	nkunim di foɔ
nkunim	nkunim
nkuraseɛ	nkura se ɛ
nkurɔfoɔ	n kurɔ foɔ
Nkwadaa	N kwadaa
Nkwaeɛso	Nkwae ɛ so
nkwa	nkwa
nkwan	n kwan
nkyɛ	n kyɛ
nkyerɛɛ	n kyerɛ ɛ
nkyerɛkyerɛmu	n kyerɛ kyerɛ mu
nkyerɛmu	n kyerɛ mu
nkyerɛ	n kyerɛ
nnaano	n na ano
nnaduafoɔ	n <n>adua foɔ
nnamfofoɔ	n <n>amfo foɔ
nna	nna
nnan	n nan
nnano	n nano
nnante	n nante
nnawɔtwe	n nawɔtwe
nneɛma	n <n>e ɛ ma
nnɛ	nnɛ
nnɛteɛ	nnɛ teɛ
nni	nni
nnipa	n nipa
nnnoɔma	n nnoɔma
nnoa	n noa
nnɔn	n nɔn
Nnua	N nua
nnum	n num
nnuru	n nuru
nnwu	n nwu
nnya	n nya
nnye	n nye
nnyɛ	n nyɛ
nnyinasoɔ	n nyina soɔ
nɔma	nɔma
nom	nom
nɔ	nɔ
nsadwaase	nsa dwaase
nsakraeɛ	n sakrae ɛ
nsam	n sam
nsamsoɔ	nsam soɔ
nsane	n sane
nsa	nsa
nseɛdo	nseɛ do
nsɛmfo	nsɛm fo
Nsɛm	N sɛm
nsɛnhunu	nsɛn hunu
Nsɛnkeka	Nsɛn keka
nse	nse
Nsɛ	Nsɛ
nsɛntwerɛfoɔ	nsɛn twerɛ foɔ
nsɛntwerɛfoɔ	nsɛn twerɛ foɔ
nsia	nsia
nso	nso
nsɔ	n sɔ
nsɔreɛ	n sɔre ɛ
nsɔre	n sɔre
nsrahwɛ	nsra hwɛ
Nsuo	Nsuo
Ntaafoɔ	Ntaa foɔ
ntae	n ta e
ntam	n tam
Nteaseɛ	Ntease ɛ
nteeɛ	nte eɛ
ntɛm	n tɛm
ntena	n tena
nte	n te
ntɛntɛntɛm	ntɛntɛntɛm
nti	nti
ntira	n tira
ntɔkwa	ntɔkwa
ntom	n tom
ntɔ	n tɔ
ntoosi	ntoosi
ntorɔ	n torɔ
Ntɔtorɔso	N tɔ torɔ so
ntuaa	n tua a
ntua	n tua
ntumi	n tumi
ntu	n tu
nua	nua
num	num
nwansena	nwansena
Nwanwani	Nwa nwa ni
nwineeɛ	nwin eeɛ
nwini	n wini
nwura	n wura
nyaa	n yaa
nyaeɛ	n yaeɛ
Nyame	Nyame
nyamu	n yamu
Nyankopɔn	Nyankopɔn
nyan	n yan
nyansa	nyansa
nya	n ya
Nyarewa	N yare wa
nyɛɛ	nyɛ ɛ
Nyɛ	N yɛ
nyiaa	n yia a
nyinaa	nyina a
nyiyimu	n yiyi mu
ɔakɔ	ɔ a kɔ
ɔayɛ	ɔ a yɛ
ɔbaa	ɔ baa
ɔba	ɔ ba
Ɔba	Ɔ ba
ɔbɛba	ɔ bɛ ba
ɔbɛbu	ɔ bɛ bu
ɔbɛfa	ɔ bɛ fa
ɔbɛfiri	ɔ bɛ firi
ɔbɛgya	ɔ bɛ gya
ɔbɛgye	ɔ bɛ gye
ɔbɛhwɛ	ɔ bɛ hwɛ
ɔbɛkaa	ɔ bɛ ka a
ɔbɛkasaeɛ	ɔ bɛ kasa eɛ
ɔbɛkasa	ɔ bɛ kasa
ɔbɛma	ɔ bɛ ma
ɔbɛ	ɔ bɛ
ɔbɛpɛ	ɔ bɛ pɛ
ɔbɛsan	ɔ bɛ san
ɔbɛto	ɔ bɛ to
ɔbɛtumi	ɔ bɛ tumi
ɔbɛtwam	ɔ bɛ twam
ɔbɛtwerɛ	ɔ bɛ twerɛ
ɔbɛwie	ɔ bɛ wie
ɔbɛyɛɛ	ɔ bɛ yɛ ɛ
Ɔbɛyɛɛ	Ɔ bɛ yɛ ɛ
ɔbɛyɛ	ɔ bɛ yɛ
obiara	obiara
Obi	Obi
obira	o bira
ɔbisa	ɔ bisa
Ɔbɔɔ	Ɔ bɔ ɔ
Obuaseman	Obuase man
ɔde	ɔ de
Ɔdidi	Ɔ di di
Ɔdikrɛɛ	Ɔ di krɛ ɛ
ɔdi	ɔ di
ɔdɔ	ɔ dɔ
Ɔfaa	Ɔ fa a
ɔfese	ɔ fese
ɔfiri	ɔ firi
Ɔfiri	Ɔ firi
Ɔgu	Ɔ gu
ɔgyaa	ɔ gya a
ɔgye	ɔ gye
ɔhene	ɔ hene
ɔhuri	ɔ huri
ɔhwɛ	ɔ hwɛ
ɔhyɛɛ	ɔ hyɛ ɛ
ɔhyɛ	ɔ hyɛ
ɔkaeɛ	ɔ kae ɛ
ɔkae	ɔ kae
Ɔkan	Ɔ kan
ɔka	ɔ ka
ɔkasaeɛ	ɔ kasa eɛ
Ɔkɔeɛ	Ɔ kɔ eɛ
ɔkɔgyee	ɔ kɔ gye e
ɔkɔgyinaa	ɔ kɔ gyina a
ɔkɔka	ɔ kɔ ka
ɔkɔmhyɛni	ɔ kɔm hyɛ ni
ɔko	ɔ ko
ɔkɔ	ɔ kɔ
Ɔkɔ	Ɔ kɔ
Ɔkɔɔ	Ɔ kɔ ɔ
ɔkɔpuee	ɔ kɔ pue e
ɔkɔsesa	ɔ kɔ sesa
ɔkura	ɔ kura
ɔkyena	ɔ kyena
ɔkyɛ	ɔ kyɛ
ɔmaa	ɔ ma a
ɔmamfoɔ	ɔ mam foɔ
ɔmanfoɔ	ɔ man foɔ
ɔman	ɔ man
Ɔman	Ɔ man
ɔmanpanin	ɔ man panin
Ɔmanpanin	Ɔ man panin
ɔmanpanyin	ɔ man panyin
ɔma	ɔ ma
ɔmfa	ɔ m fa
Ɔmfa	Ɔ m fa
ɔmmɛboa	ɔ m <m>ɛ boa
ɔmmra	ɔ m <m>ra
ɔmo	ɔ mo
Ɔmo	Ɔ mo
ɔmpue	ɔ m pue
ɔnam	ɔ nam
ɔne	ɔ ne
ɔnim	ɔ nim
onimuonyamfoɔ	o nimuonyam foɔ
Onipa	O nipa
ɔnisoɔdehunu	ɔ niso ɔ de hunu
ɔnkɔ	ɔ n kɔ
ɔnnya	ɔ n <n>ya
ɔno	ɔ no
Ɔno	Ɔ no
ɔnsi	ɔ n si
Ɔnsue	Ɔ n sue
ɔnto	ɔ n to
Onyame	Onyame
ɔnya	ɔ n ya
ɔnyɛ	ɔ n yɛ
Ɔnyɛ	Ɔ n yɛ
ɔnyi	ɔ n yi
Ɔpanini	Ɔ panin i
opanin	o panin
Ɔpanin	Ɔ panin
ɔpa	ɔ pa
ɔpɛ	ɔ pɛ
Ɔpɛ	Ɔ pɛ
ɔpepepeepeepee	ɔpepepeepeepee
Opiraeɛ	O pira eɛ
opira	o pira
ɔplay	ɔ play
ɔpue	ɔ pue
ɔrebɛhwehwɛ	ɔ re bɛ hwe hwɛ
ɔrebɛsɔ	ɔ re bɛ sɔ
ɔrebɔ	ɔ re bɔ
ɔredwane	ɔ re dwane
ɔrefa	ɔ re fa
ɔregyina	ɔ re gyina
ɔrehwɛ	ɔ re hwɛ
ɔrekɔda	ɔ re kɔ da
Ɔrema	Ɔ re ma
ɔrentumi	ɔ re n tumi
ɔrepa	ɔ re pa
ɔrepue	ɔ re pue
ɔreto	ɔ re to
ɔretu	ɔ re tu
ɔrewura	ɔ re wura
ɔreyɔ	ɔ re yɔ
Osafo	Osafo
Ɔsan	Ɔ san
osebre	o se bre
ɔse	ɔ se
Ɔse	Ɔ se
osono	osono
Ɔsono	Ɔsono
ɔtena	ɔ tena
Ɔte	Ɔ te
ɔtim	ɔ tim
ɔto	ɔ to
ɔtɔ	ɔ tɔ
otua	o tua
ɔtua	ɔ tua
ɔtumi	ɔ tumi
ɔtuu	ɔ tu u
ɔwɔ	ɔ wɔ
Ɔwɔ	Ɔ wɔ
owuo	owuo
Owura	Owura
ɔyareɛ	ɔ yare ɛ
ɔyɛɛ	ɔ yɛ ɛ
Ɔyɛɛ	Ɔ yɛ ɛ
ɔyii	ɔ yi i
Oyi	O yi
paa	pa a
paapa	paapa
pagya	pagya
pamo	pamo
panin	panin
Pa	Pa
papaapa	papaapa
papa	papa
Pee	Pee
peepeepeepee	peepeepeepee
pɛn	pɛn
pɛ	pɛ
pɛpɛɛpɛ	pɛ pɛ ɛ pɛ
peprɛpeprɛ	peprɛ peprɛ
pere	pere
pi	pi
Polisifoɔ	Polisi foɔ
polisini	polisi ni
poma	poma
pono	pono
po	po
pɔ	pɔ
porɛeɛ	porɛe ɛ
pɔtee	pɔtee
pra	pra
pue	pue
reba	re ba
rebɛhwehwɛ	re bɛ hwe hwɛ
rebɛka	re bɛ ka
rebɛkyerɛ	re bɛ kyerɛ
rebɛsesa	re bɛ sesa
rebɛtwa	re bɛ twa
rebɛyɛ	re bɛ yɛ
redi	re di
refiri	re firi
rehuru	re huru
rehwɛ	re hwɛ
rekasa	re kasa
rekɔhyɛ	re kɔ hyɛ
rekɔ	re kɔ
rekyere	re kyere
repue	re pue
resan	re san
resere	re sere
retae	re ta e
retenetene	re tene tene
reto	re to
retɔ	re tɔ
retua	re tua
retuatua	re tua tua
retwɛn	re twɛn
rewura	re wura
reyɛ	re yɛ
saa	sa a
sabi	sabi
sane	sane
san	san
sɛbe	sɛ be
Sɛdeɛ	Sɛ de ɛ
sɛde	sɛ de
see	se e
Seesei	Seesei
senea	sene a
sɛn	sɛn
sesaa	sesa a
sesa	sesa
se	se
Sɛ	Sɛ
sɛsɛɛ	sɛ sɛɛ
sie	sie
siiɛ	sii ɛ
sii	sii
Sika	Sika
sini	sini
si	si
sisii	sisi i
sisi	sisi
soa	soa
sofoɔ	sofoɔ
sɔfoɔ	sɔfoɔ
som	som
soɔ	soɔ
soro	soro
so	so
stationsfoɔ	stations foɔ
sua	sua
sukuu	sukuu
sum	sum
susua	susua
Tamalefoɔ	Tamale foɔ
tantan	tan tan
ta	ta
tebea	te bea
tee	te e
teɛ	te ɛ
Tenaa	Tena a
tena	tena
Te	Te
tɛ	tɛ
tiaa	tia a
tie	ti e
tipa	ti pa
tiri	tiri
ti	ti
tokuro	to kuro
tom	tom
tɔn	tɔn
tɔɔn	tɔ ɔ n
too	to o
toɔ	toɔ
tɔɔ	tɔ ɔ
toraa	tora a
tɔtee	tɔte e
to	to
tɔ	tɔ
toto	to to
tuaa	tua a
tua	tua
tumidie	tumi die
tumi	tumi
tuo	tuo
tu	tu
twaeɛ	twae ɛ
twamm	twam m
twa	twa
twɛn	twɛn
twerɛ	twerɛ
twe	twe
twetwee	twe twe e
twɛtwɛpoa	twɛ twɛ poa
twi	twi
two	two
wabae	w a ba e
wabaɛyɛ	w aba ɛyɛ
w'aba	w' a ba
waba	w a ba
wabɛforo	w a bɛ foro
wabɛka	w a bɛ ka
waben	w a ben
wabɛtena	w a bɛ tena
wabɛyɛ	wa bɛ yɛ
wabɛyi	w a bɛ yi
wabɔ	w a bɔ
wabue	w a bue
wadi	w a di
w'adwene	w' a dwene
wae	wa e
wafrɛ	w a frɛ
wagye	w a gye
wahunu	w a hunu
Wahu	W a hu
wahyɛ	w a hyɛ
wakasa	w a kasa
wakɔfa	w a kɔ fa
wakyea	w a kye a
wakyekyere	w a kye kyere
Wakyerɛkyerɛ	W a kyerɛ kyerɛ
wakyerɛ	w a kyerɛ
w'amammerɛ	w' ama <m> merɛ
wama	w a ma
wamuna	w a muna
wanante	w a nante
w'anim	w' a nim
w'ani	w' a ni
w'ano	w' ano
wantie	w a n tie
wanya	w a n ya
wasane	w a sane
wasan	w a san
Wasa	W a sa
w'asɛdeɛ	w' a sɛ deɛ
wasesa	w a sesa
w'asetena	w' ase tena
wate	w a te
watumi	w a tumi
wayi	w a yi
wei	wei
werɛ	werɛ
wiase	wiase
wieeɛ	wie eɛ
wiem	wiem
wie	wie
woaba	wo a ba
wɔaba	wɔ a ba
wɔabɛgu	wɔ a bɛ gu
woabɛtwam	wo a bɛ twam
wɔabɛyɛ	wɔ a bɛ yɛ
Wɔaboa	Wɔ a boa
woabɔ	wo a bɔ
wɔabɔ	wɔ a bɔ
woadaworoma	wo adaworoma
woadi	wo a di
wɔadum	wɔ a dum
wɔagya	wɔ a gya
wɔagye	wɔ a gye
Woahunu	Wo a hu nu
wɔahyɛ	wɔ a hyɛ
woakan	wo a kan
wɔaka	wɔ a ka
wɔakɔfa	wɔ a kɔ fa
wɔakɔsesa	wɔ a kɔ sesa
woakɔto	wo a kɔ to
woakɔ	wo a kɔ
wɔakɔ	wɔ a kɔ
woanim	wo anim
Woantumi	Wo a n tumi
woanya	wo a n ya
wɔanya	wɔ a n ya
woanyɛ	wo a n yɛ
wɔapaakepaake	wɔ a paake paake
woapepa	wo a pepa
woara	woara
wɔasane	wɔ a sane
woasan	wo a san
wɔasan	wɔ a san
wɔasɛesɛe	wɔ a sɛe sɛe
woasie	wo asie
wɔasi	wɔ a si
wɔasɔ	wɔ a sɔ
woatena	wo a tena
Woate	Wo a te
wɔate	wɔ a te
wɔatoa	wɔ a toa
wɔatoto	wɔ a to to
wɔatɔ	wɔ a tɔ
wɔatu	wɔ a tu
wɔatwe	wɔ a twe
woa	woa
woayɛ	wo a yɛ
wɔayɛ	wɔ a yɛ
wɔayi	wɔ a yi
wɔbaa	wɔ ba a
wɔbaeɛ	wɔ ba eɛ
woba	wo ba
wɔba	wɔ ba
Wobɛba	Wo bɛ ba
wobɛbue	wo bɛ bue
wɔbɛbue	wɔ bɛ bue
wobɛbu	wo bɛ bu
wobɛduru	wo bɛ duru
wɔbɛdwo	wɔ bɛ dwo
wobɛfrɛ	wo bɛ frɛ
wobɛhunu	wo bɛ hu nu
wɔbɛhunu	wɔ bɛ hu nu
Wobɛhwɛ	Wo bɛ hwɛ
Wobɛkae	Wo bɛ kae
wobɛkɔ	wo bɛ kɔ
wobɛma	wo bɛ ma
wobɛnom	wo bɛ nom
wobɛnya	wo bɛ nya
wobɛpɛ	wo bɛ pɛ
wobɛsane	wo bɛ sane
wɔbɛsa	wɔ bɛ sa
wobɛtie	wo bɛ tie
wɔbɛtɔadeɛ	wɔ bɛ tɔ ade ɛ
wɔbɛto	wɔ bɛ to
wobɛtua	wo bɛ tua
wɔbɛyɛɛe	wɔ bɛ yɛ ɛe
wɔbɛyɛɛ	wɔ bɛ yɛ ɛ
wobɛyɛ	wo bɛ yɛ
wɔbɛyɛ	wɔ bɛ yɛ
Wobisa	Wo bisa
wobɔ	wo bɔ
wobɔwura	wo bɔ wura
wodane	wo dane
Wodeɛ	Wo de ɛ
wode	wo de
wɔde	wɔ de
wɔdi	wɔ di
wɔdumm	wɔ dum m
wɔdum	wɔ dum
wɔduruu	wɔ duru u
Wofa	Wo fa
wɔfa	wɔ fa
Wofiri	Wo firi
Wofo	Wo fo
wɔfrɛ	wɔ frɛ
wogya	wo gya
Wogye	Wo gye
wɔgye	wɔ gye
wogyina	wo gyina
wɔhane	wɔ hane
wɔhɔ	wɔ hɔ
Wɔhunuiɛ	Wɔ hu nu iɛ
wohunuuiɛ	wo hu nu u iɛ
wohunuu	wo hu nu u
wɔhunuu	wɔ hu nu u
Wohwɛ	Wo hwɛ
wɔka	wɔ ka
wokɔduru	wo kɔ duru
Wokɔɔ	Wokɔ ɔ
wɔkɔtenaa	wɔ kɔ tena a
wokɔtɔn	wo kɔ tɔn
wokɔto	wo kɔ to
wokɔtɔ	wo kɔ tɔ
wɔkɔ	wɔ kɔ
wɔkura	wɔ kura
wokuta	wo ku ta
Wɔkyerɛɛ	Wɔ kyerɛ ɛ
wɔkyerɛ	wɔ kyerɛ
wɔmaa	wɔ ma a
woma	wo ma
womfa	wo m fa
wɔmfa	wɔ m fa
wɔmma	wɔ m <m>a
wɔmmɛhunu	wɔ m <m>ɛ hu nu
wɔmmɛsa	wɔ m <m>ɛsa
wɔmmoa	wɔ m <m>oa
wommɔɔ	wo m <m>ɔ ɔ
wɔmmra	wɔ m <m>ra
wɔmpɛ	wɔ m pɛ
wom	wom
wonam	wo nam
wɔneɛ	wɔ ne ɛ
wonenam	wo ne nam
wɔnenam	wɔ ne nam
wone	wo ne
wɔne	wɔ ne
Wonhunu	Wo n hu nu
wɔnhunu	wɔ n hu nu
Wɔnhwɛ	Wɔ n hwɛ
wɔnhyɛɛ	wɔ n hyɛ ɛ
Wonim	Wo nim
wɔnim	wɔ nim
wɔnkɔto	wɔ n kɔ to
wɔnkɔtwa	wɔ n kɔ twa
wonnim	wo n <n>im
wɔnnim	wɔ n <n>im
wonni	wo n <n>i
wɔnni	wɔ n <n>i
wɔnnya	wɔ n <n>ya
wonnye	wo n <n>ye
wɔnnye	wɔ n <n>ye
wɔnom	wɔ nom
wontua	wo n tua
wɔntua	wɔ n tua
wontumi	wo n tumi
wɔntumi	wɔ n tumi
wɔntwe	wɔ n twe
wonua	wo nua
Wɔn	Wɔn
wonyaeɛ	wo n ya eɛ
Wonyare	Wo n yare
wɔnya	wɔ n ya
wɔnyɛ	wɔ n yɛ
wonyin	wo n yin
wɔnyi	wɔ n yi
wopɛ	wo pɛ
wɔpɛ	wɔ pɛ
Wɔpɔn	Wɔ pɔn
wɔprapra	wɔ pra pra
wɔpuiɛ	wɔ pui ɛ
woreba	wo re ba
wɔreba	wɔ re ba
wɔrebɛpre	wɔ re bɛ pre
wɔrebɛsene	wɔ re bɛ sene
worebɛtena	wo re bɛ tena
wɔrebɛwodwo	wɔ re bɛ wo dwo
worebɛ	wo re bɛ
wɔrebɔ	wɔ re bɔ
wɔrebu	wɔ re bu
wɔredi	wɔ re di
wɔrefa	wɔ re fa
wɔregya	wɔ re gya
wɔrehwehwɛ	wɔ re hwe hwɛ
worehwɛ	wo re hwɛ
wɔrehwɛ	wɔ re hwɛ
woreka	wo re ka
worekɔfa	wo re kɔ fa
wɔrekɔka	wɔ re kɔ ka
worekɔto	wo re kɔ to
worekɔ	wo re kɔ
wɔrekɔ	wɔ re kɔ
wɔrekyerɛ	wɔ re kyerɛ
wɔrema	wɔ re ma
wɔrensesa	wɔ re n sesa
woresane	wo re sane
wɔretie	wɔ re tie
woreto	wo re to
woretua	wo re tua
wɔretwa	wɔ re twa
woreyɛ	wo re yɛ
wɔreyɛ	wɔ re yɛ
wɔsan	wɔ san
wɔsee	wɔ se e
wɔsesa	wɔ sesa
wose	wo se
woso	wo so
wosusu	wo su su
wotee	wo te e
wɔtete	wɔ te te
Wote	Wo te
wɔte	wɔ te
wotɛ	wo tɛ
wɔtoa	wɔ toa
wotom	wo tom
wɔtɔn	wɔ tɔn
woto	wo to
wɔto	wɔ to
Wotuatua	Wo tua tua
wotua	wo tua
wɔtua	wɔ tua
wotumi	wo tumi
wɔtwaa	wɔ twa a
wotwerɛɛ	wo twerɛ ɛ
wo	wo
wowɔ	wo wɔ
wɔwɔ	wɔ wɔ
wowowo	wo wo wo
woyɛɛ	wo yɛ ɛ
wɔyɛɛ	wɔ yɛ ɛ
woyɛ	wo yɛ
Wɔyɛ	Wɔ yɛ
wɔyii	wɔ yi i
wɔyi	wɔ yi
Wukuada	Wukuada
wuraa	wura a
wura	wura
Wusu	Wu su
wuu	wu u
Wwankasa	W wa n kasa
yade	y a de
yam	yam
yarefoɔ	yare foɔ
yare	yare
yaw	yaw
ya	ya
yɛaba	yɛ a ba
yɛabisa	yɛ a bisa
yɛabobɔ	yɛ a bo bɔ
yɛabɔ	yɛ a bɔ
yɛabu	yɛ a bu
yɛadi	yɛ a di
yɛadum	yɛ a dum
yɛaduru	yɛ a duru
yɛagyegye	yɛ a gye gye
yɛagye	yɛ a gye
yɛagyina	yɛ a gyina
yɛahunu	yɛ a hu nu
yɛahwɛ	yɛ a hwɛ
yɛahyehyɛ	yɛ a hye hyɛ
Yɛakan	Yɛ a kan
Yɛakɔbɔ	Yɛ a kɔ bɔ
yɛakɔduru	yɛ a kɔ duru
yɛakɔhu	yɛ a kɔ hu
yɛakɔte	yɛ a kɔ te
Yɛakɔ	Yɛ a kɔ
Yɛakyekyere	Yɛ a kye kyere
yɛama	yɛ a ma
yɛamfa	yɛ a <m> fa
yɛammoro	yɛ a <m>moro
yɛanhwɛ	yɛ a n hwɛ
yɛani	yɛ ani
yɛanto	yɛ a n to
yɛantua	yɛ a n tua
yɛanya	yɛ a n ya
yɛapamo	yɛ a pamo
Yɛapam	Yɛ a pam
yɛapene	yɛ a pene
yɛapɔn	yɛ a pɔn
Yɛasan	Yɛ a san
yɛasesa	yɛ a sesa
yɛasoa	yɛ a soa
yɛasɔre	yɛ a sɔre
yɛatie	yɛ a tie
yɛatoa	yɛ a toa
yɛatoto	yɛ a to to
yɛatɔ	yɛ a tɔ
yɛatumi	yɛ a tumi
yɛawura	yɛ a wura
yea	ye a
yɛa	yɛ a
yɛayɛ	yɛ a yɛ
yɛbaa	yɛ ba a
yɛbaeɛ	yɛ ba e ɛ
yɛba	yɛ ba
yɛbɛbisa	yɛ bɛ bisa
yɛbɛbɔ	yɛ bɛ bɔ
yɛbɛdane	yɛ bɛ dane
yɛbɛgya	yɛ bɛ gya
yɛbɛgye	yɛ bɛ gye
Yɛbɛhwɛeɛ	Yɛ bɛ hwɛ eɛ
Yɛbɛhwɛ	Yɛ bɛ hwɛ
yɛbɛka	yɛ bɛ ka
Yɛbɛkɔ	Yɛ bɛ kɔ
yɛbɛkye	yɛ bɛ kye
Yɛbɛma	Yɛ bɛ ma
yɛbɛnya	yɛ bɛ nya
yɛbɛn	yɛ bɛn
Yɛbɛsere	Yɛ bɛ sere
yɛbɛserɛ	yɛ bɛ serɛ
Yɛbɛsesa	Yɛ bɛ sesa
Yɛbɛsrɛ	Yɛ bɛ srɛ
Yɛbɛtoo	Yɛ bɛ to o
yɛbɛto	yɛ bɛ to
Yɛbɛtumi	Yɛ bɛ tumi
yɛbɛwu	yɛ bɛ wu
yɛbɛ	yɛ bɛ
yɛbɛyɛ	yɛ bɛ yɛ
yɛboa	yɛ boa
yɛbɔɔ	yɛ bɔ ɔ
yɛboro	yɛ boro
yɛbɔ	yɛ bɔ
Yɛda	Yɛ da
yɛdeda	yɛ deda
yɛdeɛ	yɛ de ɛ
yɛde	yɛ de
yɛdii	yɛ di i
yɛdi	yɛ di
yɛdum	yɛ dum
yɛduruiɛ	yɛ duru iɛ
yɛduruu	yɛ duru u
yee	ye e
yɛɛ	yɛ ɛ
yɛfa	yɛ fa
yɛfi	yɛ fi
yɛfrɛ	yɛ frɛ
Yɛgu	Yɛ gu
yɛgyaa	yɛ gya a
yɛgye	yɛ gye
yɛgyina	yɛ gyina
Yɛhia	Yɛ hia
yɛhunuiɛ	yɛ hu nu iɛ
yɛhunuu	yɛ hu nu u
yɛhunu	yɛ hu nu
yɛhwɛ	yɛ hwɛ
yeifoɔ	yei foɔ
Yei	Yei
yɛka	yɛ ka
yɛkɔbɔeɛ	yɛ kɔ bɔ eɛ
Yɛkɔɔ	Yɛ kɔ ɔ
Yɛkɔpuee	Yɛ kɔ pue e
yɛkɔtɔ	yɛ kɔ tɔ
yɛko	yɛ ko
Yɛkɔ	Yɛ kɔ
yɛma	yɛ ma
yɛmfa	yɛ m fa
yɛmma	yɛ m <m>a
yɛmmɛfaeɛ	yɛ m <m>ɛ fae ɛ
yɛmmɛsesa	yɛ m <m>ɛ sesa
yɛmmɔɔ	yɛ m <m>ɔ ɔ
yɛmmɔ	yɛ m <m>ɔ
yɛmmra	yɛ m <m>ra
Yɛmpɛ	Yɛ m pɛ
yɛmpɔn	yɛ m pɔn
yɛnam	yɛ nam
yɛnante	yɛ nante
Yɛne	Yɛ ne
yɛnhunuu	yɛn hu nu u
yɛnhwɛ	yɛn hwɛ
yɛnhyehyɛ	yɛn hye hyɛ
Yɛnim	Yɛ nim
yɛnkaa	yɛ n ka a
yɛnka	yɛ n ka
yɛnkɔeɛ	yɛ n kɔ eɛ
Yɛnkɔ	Yɛ n kɔ
Yɛnnim	Yɛ n<n>im
Yɛnni	Yɛ n <n>i
yɛntena	yɛ n tena
yɛntɔ	yɛ n tɔ
yɛntumi	yɛ n tumi
yɛnyaa	yɛ nya a
Yɛnya	Yɛ nya
Yɛn	Yɛn
yɛn-yɛntumi	yɛn - yɛ n tumi 
yɛnyɛ	yɛ n yɛ
Yɛnyina	Yɛ nyina
yɛpagya	yɛ pagya
yɛpɛ	yɛ pɛ
yɛpira	yɛ pira
yɛpue	yɛ pue
yɛreba	yɛ re ba
yɛrebɛtena	yɛ re bɛ tena
Yɛrebɔ	Yɛ re bɔ
yɛrebrɛ	yɛ re brɛ
yɛredan	yɛ re dan
yɛredidi	yɛ re di di
yɛredi	yɛ re di
yɛrefa	yɛ re fa
yɛregu	yɛ re gu
yɛrehwɛ	yɛ re hwɛ
Yɛreka	Yɛ re ka
yɛrekɔko	yɛ re kɔ ko
Yɛreko	Yɛ re ko
Yɛrekɔ	Yɛ re kɔ
yɛrenhia	yɛ re n hia
yɛrenya	yɛ re n ya
yɛrepra	yɛ re pra
Yɛresesa	Yɛ re sesa
yɛresom	yɛ re som
yɛresrɛ	yɛ re srɛ
yɛresu	yɛ re su
yɛrete	yɛ re te
Yɛretoa	Yɛ re to a
yɛretom	yɛ re tom
yɛretɔn	yɛ re tɔn
yɛreto	yɛ re to
yɛretu	yɛ re tu
yɛretwa	yɛ re twa
yɛretwɛn	yɛ re twɛn
yɛretwetwe	yɛ re twe twe
yere	ye re
yɛre	yɛ re
yɛreyɛ	yɛ re yɛ
yɛsane	yɛ sane
yɛsan	yɛ san
yɛsesa	yɛ sesa
Yɛsrɛ	Yɛ srɛ
yɛsusu	yɛ susu
yɛteeɛ	yɛ te eɛ
yɛtee	yɛ te e
Yɛtena	Yɛ tena
yɛ-tete	yɛ - te te
yɛtete	yɛ te te
yɛte	yɛ te
yɛtoo	yɛ to o
yɛtoɔ	yɛ toɔ
Yɛtotoo	Yɛ to too
yɛto	yɛ to
yɛtɔ	yɛ tɔ
yɛtua	yɛ tua
yɛtumi	yɛ tumi
yɛtutuu	yɛ tu tu u
Yɛtu	Yɛ tu
yɛtwa	yɛ twa
yɛweene	yɛ weene
Yɛwieɛ	Yɛ wie ɛ
Yɛwie	Yɛ wie
yɛwoo	yɛ wo o
yɛwɔɔ	yɛ wɔ ɔ
Yɛwɔ	Yɛ wɔ
yɛw	yɛw
yɛyare	yɛ yare
Yɛ	Yɛ
yeyɛeɛ	ye yɛ eɛ
yɛyɛɛ	yɛ yɛ ɛ
yɛyeyɛɛ	yɛ ye yɛ ɛ
yɛyɛ	yɛ yɛ
yɛyi	yɛ yi
yiiɛ	yi i ɛ
yi	yi
yɔnko	yɔ n ko
yooo	yooo
Yoo	Yoo
yɔwɔ	y ɔ wɔ
yɔ	yɔ
