token	transliteration	segmentation
அகதி	ahadhi	ahadhi
அகற்றும்	ahatrum	ahatrum
அக்னி	akni	akni
அங்க	anga	anga
அங்கிருந்து	angirundhu	ang irundhu
அங்கீகரிக்கப்பட்ட	angiiharikkappatta	ang iiharikka ppatta
அங்கே	angee	angee
அசந்த	asandha	asan dha
அசந்து	asandhu	asan dhu
அசர்ந்து	asarndhu	asarn dhu
அச்சத்தில்	achchaththil	achch athth il
அச்சம்	achcham	achch am
அச்சுறுத்தல்	achchuruththal	achch uru ththal
அஞ்சப்படுகிறது	anjappaduhiradhu	anja ppadu hir adhu
அடி	adi	adi
அடித்த	adiththa	adi ththa
அடித்து	adiththu	adi ththu
அடித்துச்	adiththuch	adi ththu ch
அடித்தும்	adiththum	adi ththu m
அடிப்படை	adippadai	adi ppad ai
அடிப்படையாகக்	adippadaiyaahak	adi ppadai yaahak
அடியில்	adiyil	adi yil
அடுத்தடுத்து	aduththaduththu	aduthth aduththu
அடுத்து	aduththu	aduththu
அடைந்த	adaindha	adai ndha
அடைந்து	adaindhu	adai ndhu
அடையாளம்	adaiyaalam	adai yaalam
அடையும்	adaiyum	adai yum
அணிதல்	anidhal	ani dhal
அணு	anu	anu
அணுக்கழிவுகள்	anukkazivuhal	anu kkazivu hal
அணை	anai	anai
அணைகள்	anaihal	anai hal
அண்டிய	antiya	anti ya
அண்டை	antai	antai
அண்ணா	annaa	annaa
அண்மையில்	anmaiyil	anmai yil
அதற்கு	adharku	adha rku
அதன்	adhan	adhan
அதாவது	adhaavadhu	adha ava dhu
அதி	adhi	adhi
அதிக	adhiha	adhi ha
அதிகமழையையும்	adhihamazaiyaiyum	adhi ham azai yai yum
அதிகமாக	adhihamaaha	adhi ham aaha
அதிகமான	adhihamaana	adhi ham aana
அதிகமானோர்	adhihamaanoor	adhi ham aanoor
அதிகம்	adhiham	adhi ham
அதிகரிக்கிறது	adhiharikkiradhu	adhi hari kkir adhu
அதிகரிக்கும்	adhiharikkum	adhi hari kkum
அதிகரித்துள்ளது	adhihariththulladhu	adhi hari<thth> ull adhu
அதிகரிப்பு	adhiharippu	adhi hari ppu
அதிகாரத்தை	adhihaaraththai	adhi haara thth ai
அதிகாரி	adhihaari	adhi haari
அதிகாரிகளுக்கு	adhihaarihalukku	adhi haari hal ukku
அதிகாரிகள்	adhihaarihal	adhi haari hal
அதிகாலை	adhihaalai	adhi haalai
அதிபர்	adhibar	adhi bar
அதிமுக	adhimuha	adhi muha
அதிமுகவினர்	adhimuhavinar	adhi muha vinar
அதிர்ச்சி	adhirchchi	adhi rchchi
அதிர்வு	adhirvu	adhi rvu
அதிர்வுகள்	adhirvuhal	adhi rvu hal
அதில்	adhil	adhil
அது	adhu	adhu
அதுமட்டுமில்லாமல்	adhumattumillaamal	adhu mattum illaa mal
அதே	adhee	adhee
அதேபோல	adheeboola	adhee boola
அதேபோல்	adheebool	adhee bool
அதேவேளை	adheeveelai	adhee veelai
அதை	adhai	adhai
அத்துடன்	aththudan	aththu dan
அத்துமீறி	aththumiiri	aththu miiri
அந்த	andha	andha
அந்தந்த	andhandha	andha ndha
அந்நாட்டின்	annaattin	ann aatt in
அந்நாட்டு	annaattu	ann aattu
அபாய	abaaya	abaaya
அபாயமும்	abaayamum	abaaya mum
அப்துல்	apthul	ap thul
அப்ப	appa	appa
அப்பகுதி	appahudhi	app ahudhi
அப்பால்	appaal	app aal
அப்புறப்படுத்துமாறும்	appurappaduththumaarum	app urappad uththu maarum
அப்புறம்	appuram	app uram
அமர்ந்து	amarndhu	amar ndhu
அமெரிக்காவில்	amerikkaavil	amer ikkaa vil
அமெரிக்காவின்	amerikkaavin	amer ikkaa vin
அமெரிக்காவும்	amerikkaavum	amer ikkaa vum
அமைக்க	amaikka	amai kka
அமைக்கப்பட்டிருக்கும்	amaikkappattirukkum	amai kka ppatti rukk um
அமைச்சகம்	amaichchaham	amai chcha ham
அமைச்சரவை	amaichcharavai	amai chchar avai
அமைச்சரவைக்	amaichcharavaik	amai chchar avai k
அமைச்சராக	amaichcharaaha	amai chchar aaha
அமைச்சர்கள்	amaichcharkal	amai chchar kal
அமைச்சின்	amaichchin	amai ch chin
அமைந்துள்ள	amaindhulla	amai ndh ulla
அமைப்பது	amaippadhu	amai ppadhu
அமைப்பு	amaippu	amai ppu
அமைப்பை	amaippai	amai ppai
அமையும்	amaiyum	amai yum
அம்மை	ammai	amm ai
அரசாங்க	arasaanga	ara saang a
அரசாங்கத்தின்	arasaangaththin	ara saanga ththin
அரசாங்கம்	arasaangam	ara saang am
அரசியல்	arasiyal	ara siyal
அரசின்	arasin	ara sin
அரசு	arasu	ara su
அரசுக்கு	arasukku	ara su kku
அரசுத்	arasuth	ara su th
அரசை	arasai	ara sai
அரிசி	arisi	ari si
அரிப்பு	arippu	ari ppu
அருகாமையில்	aruhaamaiyil	aru haa mai yil
அருகில்	aruhil	aru hil
அருகே	aruhee	aru hee
அருவியில்	aruviyil	aru vi yil
அலுவலகத்தில்	aluvalahaththil	alu valaha ththil
அலுவலகம்	aluvalaham	alu vala ham
அலைகள்	alaihal	alai hal
அல்லது	alladhu	alla dhu
அவசர	avasara	ava sara
அவசரமாக	avasaramaaha	ava sara maaha
அவசியம்	avasiyam	ava si yam
அவருடன்	avarudan	avar udan
அவர்களின்	avarkalin	avar kal in
அவர்களுக்கு	avarkalukku	avar kal ukku
அவர்களை	avarkalai	avar kal ai
அவர்கள்	avarkal	avar kal
அவலம்	avalam	ava lam
அவற்றில்	avatril	ava tril
அவை	avai	avai
அழகிய	azahiya	aza hiya
அழித்துக்	aziththuk	azi ththu k
அழைத்து	azaiththu	azai ththu
அழைப்பு	azaippu	azai ppu
அளவிலான	alavilaana	ala vil aana
அளவிற்கு	alavirku	ala virku
அளவு	alavu	ala vu
அளவுகோலில்	alavuhoolil	ala vu hool il
அளவுக்கு	alavukku	ala vu kku
அளிக்கும்	alikkum	ali kkum
அளித்த	aliththa	ali ththa
அளித்துள்ளது	aliththulladhu	ali ththull adhu
அளித்தோம்	aliththoom	ali thth oom
அளிப்பேன்	alippeen	ali ppeen
அறிகுறிகள்	arihurihal	ari huri hal
அறிக்கைகள்	arikkaihal	ari kkai hal
அறிக்கையில்	arikkaiyil	ari kkai yil
அறிக்கையை	arikkaiyai	ari kkai yai
அறிந்து	arindhu	ari ndhu
அறிய	ariya	ari ya
அறியமுடிகின்றது	ariyamudihinradhu	ari ya mudi hinr adhu
அறிவிக்க	arivikka	ari vikka
அறிவிக்கப்பட்டது	arivikkappattadhu	ari vikka ppatta dhu
அறிவிக்கப்பட்டுள்ளது	arivikkappattulladhu	ari vikka ppattu lladhu
அறிவித்தது	ariviththadhu	ari vithth adhu
அறிவித்துள்ளது	ariviththulladhu	ari vithth ulladhu
அறிவித்துள்ளார்	ariviththullaar	ari vithth ullaar
அறிவிப்பு	arivippu	ari vippu
அறிவியல்	ariviyal	ari viyal
அறிவுறுத்தப்பட்டுள்ளனர்	arivuruththappattullanar	ari vuru ththa ppatt ulla nar
அனர்த்த	anarththa	an arthth a
அனர்த்தத்தில்	anarththaththil	an arthth athth il
அனர்த்தத்திற்கான	anarththaththirkaana	an arthth aththirk aana
அனர்த்தத்தின்	anarththaththin	an arthth athth in
அனர்த்தத்தை	anarththaththai	an arthth athth ai
அனர்த்தம்	anarththam	an arthth am
அனுபவங்களை	anubavangalai	anu bava<n> gal ai
அனுப்பி	anuppi	anu ppi
அனுப்பியுள்ளது	anuppiyulladhu	anu ppi yulla dhu
அனுமதி	anumadhi	anu madhi
அனைத்து	anaiththu	anai ththu
அனைத்தும்	anaiththum	anai ththum
அனைவரும்	anaivarum	anai varum
அன்புடன்	anbudan	anbu dan
அன்றைக்கு	anraikku	anra ikku
அன்றைய	anraiya	anra iya
ஆகவும்	aahavum	aah avum
ஆகிய	aahiya	aah iya
ஆகியவை	aahiyavai	aah iya vai
ஆகும்	aahum	aah um
ஆக்கப்பூர்வ	aakkappuurva	aakka ppuurva
ஆக்கப்பூர்வமான	aakkappuurvamaana	aakka ppuur vam aana
ஆங்காங்கே	aangaangee	aang aangee
ஆடுகளை	aaduhalai	aadu hal ai
ஆட்சிக்கு	aatchikku	aat chi kku
ஆட்டோக்கள்	aattookkal	aat too kkal
ஆண்டில்	aantil	aant il
ஆண்டு	aantu	aantu
ஆண்டுகளாக	aantuhalaaha	aantu hal aaha
ஆண்டுகளுக்கு	aantuhalukku	aantu hal ukku
ஆண்டுதோறும்	aantudhoorum	aantu dhoorum
ஆதரவாக	aadharavaaha	aadha rav aaha
ஆதரவு	aadharavu	aadha ravu
ஆபத்தான	aabaththaana	aaba thth aana
ஆபத்து	aabaththu	aaba ththu
ஆயிரக்கணக்கான	aayirakkanakkaana	aayi rakk anakk aana
ஆயிரத்திற்கும்	aayiraththirkum	aayi rathth ir kum
ஆயிரத்து	aayiraththu	aayi rathth u
ஆயிரம்	aayiram	aayi ram
ஆயினும்	aayinum	aayi num
ஆய்வு	aayvu	aay vu
ஆய்வுக்	aayvuk	aay vu k
ஆரம்ப	aaramba	aaram ba
ஆரம்பப்	aarambap	aaram ba p
ஆரம்பித்தது	aarambiththadhu	aaram bithth adhu
ஆராய்ச்சி	aaraaychchi	aaraay chchi
ஆர்ப்பாட்டம்	aarppaattam	aar ppaa ttam
ஆலோசகர்	aaloosahar	aal oosa har
ஆலோசனை	aaloosanai	aal oosa nai
ஆழத்தில்	aazaththil	aaza thth il
ஆழ்த்தியிருக்கும்	aazhththiyirukkum	aazh ththi yirukk um
ஆளும்	aalum	aal um
ஆறு	aaru	aaru
ஆறுகளின்	aaruhalin	aaru hal in
ஆறுகளை	aaruhalai	aaru hal ai
ஆற்றில்	aatril	aat ril
ஆற்றுக்குள்	aatrukkul	aat ru kkul
ஆனாலும்	aanaalum	aan aal um
ஆனால்	aanaal	aan aal
இக்குழுமத்திலிருந்து	ikkuzumaththilirundhu	i kkuzu maththil irundhu
இக்குழுமத்தில்	ikkuzumaththil	i kkuzu mathth il
இங்க	inga	ing a
இங்கு	ingu	ing u
இங்குள்ள	ingulla	ing ulla
இங்கே	ingee	ing ee
இச்சூறாவளி	ichchuuraavali	i chch uuraa vali
இடங்களில்	idangalil	ida<n> gal il
இடங்களுக்கு	idangalukku	ida<n> gal ukku
இடங்கள்	idangal	ida<n> gal
இடத்தில்	idaththil	ida ththil
இடத்துக்கு	idaththukku	ida ththu kku
இடமில்லை	idamillai	idam illai
இடம்	idam	idam
இடம்பெற்ற	idambetra	idam betra
இடம்பெற்றது	idambetradhu	idam betr adhu
இடி	idi	idi
இடிக்கப்பட்டு	idikkappattu	idi kka ppattu
இடையிடையே	idaiyidaiyee	idaiy idaiy ee
இடையே	idaiyee	idaiy ee
இடைவெளியில்	idaiveliyil	idai veli yil
இணை	inai	inai
இணைக்கப்பட்டு	inaikkappattu	inai kka ppattu
இணைக்கும்	inaikkum	inai kkum
இணைத்தால்	inaiththaal	inai ththaal
இணைந்து	inaindhu	inai ndhu
இணைப்பாளர்	inaippaalar	inai ppaa lar
இணைப்பு	inaippu	inai ppu
இதற்கிடையே	idharkidaiyee	idhar kidai yee
இதற்கு	idharku	idhar ku
இதனிடையே	idhanidaiyee	idhan idai yee
இதனை	idhanai	idha nai
இதனைத்	idhanaith	idha nai th
இதன்	idhan	idha n
இதில்	idhil	idhil
இது	idhu	idhu
இதுதவிர	idhudhavira	idhu dhavira
இதுதான்	idhudhaan	idhu dhaan
இதுபற்றிய	idhubatriya	idhu batriya
இதுவரை	idhuvarai	idhu varai
இதேவேளை	idheeveelai	idhee veelai
இதை	idhai	idhai
இத்தாலியில்	iththaaliyil	ithth aaliyil
இந்த	indha	indha
இந்தக்	indhak	indha k
இந்தச்	indhach	indha ch
இந்தத்	indhath	indha th
இந்தப்	indhap	indha p
இந்தியக்	indhiyak	indhi ya k
இந்தியப்	indhiyap	indhi ya p
இந்தியர்கள்	indhiyarkal	indhi yar kal
இந்தியாவிலும்	indhiyaavilum	indhi yaa vil um
இந்து	indhu	indhu
இந்தோனேசியாவில்	indhooneesiyaavil	indhoo neesiyaa vil
இந்தோனேசியாவின்	indhooneesiyaavin	indhoo neesiyaa vin
இந்நிலநடுக்கம்	innilanadukkam	inni la nadu kkam
இந்நிலையில்	innilaiyil	inni lai yil
இப்ப	ippa	ippa
இப்பகுதியில்	ippahudhiyil	ippa hudhi yil
இப்படி	ippadi	ippa di
இப்பள்ளியில்	ippalliyil	ippa lliyil
இப்பாதை	ippaadhai	ipp aadhai
இப்போ	ippoo	ipp oo
இப்போது	ippoodhu	ipp oodhu
இம்மாநாடு	immaanaadu	imm aa naadu
இயக்குநர்	iyakkunar	iyakku nar
இயக்குனர்	iyakkunar	iyakku nar
இயங்கி	iyangi	iya ngi
இயல்பு	iyalpu	iya lpu
இயற்கை	iyarkai	iya rkai
இயற்கைக்கு	iyarkaikku	iya rkai kku
இயன்றவரை	iyanravarai	iyan rava rai
இரண்டாவது	irantaavadhu	iran taa vadhu
இரண்டு	irantu	iran tu
இரத்த	iraththa	ira ththa
இரவு	iravu	ira vu
இராணுவம்	iraanuvam	ir aanu vam
இரு	iru	iru
இருக்க	irukka	iru kka
இருக்கிறது	irukkiradhu	iru kkir adhu
இருக்கிறார்கள்	irukkiraarkal	iru kkir aar kal
இருதரப்பும்	irudharappum	iru dharapp um
இருத்தல்	iruththal	iru ththal
இருந்ததால்	irundhadhaal	irun dha dhaal
இருந்தது	irundhadhu	irun dha dhu
இருந்தன	irundhana	irun dhana
இருந்தாலும்	irundhaalum	irun dhaa lum
இருந்தால்	irundhaal	irun dhaal
இருந்து	irundhu	irun dhu
இருப்பதாக	iruppadhaaha	iru ppa dhaaha
இருப்பதாகவும்	iruppadhaahavum	iru ppa dhaaha vum
இருப்பிடங்களை	iruppidangalai	iru ppi dan gal ai
இருமல்	irumal	iru mal
இருவர்	iruvar	iru var
இலங்கைக்கான	ilangaikkaana	ila ngai kkaana
இலங்கைக்கு	ilangaikku	ila ngai kku
இலங்கைத்	ilangaith	ila ngai th
இலவச	ilavasa	ila vasa
இலவசம்	ilavasam	ila vasam
இல்லாத	illaadha	illaa dha
இல்லாததால்	illaadhadhaal	illaa dhadhaal
இல்லாமல்	illaamal	illaa mal
இல்லை	illai	illai
இவர்	ivar	ivar
இவர்களுக்கு	ivarkalukku	ivar kal ukku
இவர்கள்	ivarkal	ivar kal
இவை	ivai	ivai
இவ்வமைப்பின்	ivvamaippin	ivva maipp in
இவ்வளவு	ivvalavu	ivva lavu
இவ்வாறான	ivvaaraana	ivvaa raana
இழந்தவர்களின்	izandhavarkalin	izandha var kal in
இழந்தனர்	izandhanar	izandha nar
இளங்கோவனுக்கு	ilangoovanukku	ilan goova nukku
இறந்தனர்	irandhanar	iran dha nar
இறந்து	irandhu	iran dhu
இறந்துவிட்டதாக	irandhuvittadhaaha	iran dhu vitta dhaa ha
இறந்துவிட்டனர்	irandhuvittanar	iran dhu vitta nar
இறுதியில்	irudhiyil	iru dhi yil
இனி	ini	ini
இனிமேலாவது	inimeelaavadhu	ini meel aavadhu
இன்ப	inba	inba
இன்றும்	inrum	in rum
இன்றைக்கு	inraikku	in rai kku
இன்றைய	inraiya	in rai ya
இன்னும்	innum	inn um
இஸ்லாமிய	islaamiya	islaa miya
ஈடுபட	iidubada	iidu bada
ஈடுபட்ட	iidubatta	iidu batta
ஈடுபட்டனர்	iidubattanar	iidu batta nar
ஈடுபட்டிருந்த	iidubattirundha	iidu batti rundha
ஈடுபட்டுள்ளது	iidubattulladhu	iidu battu lladhu
ஈரப்பதம்	iirappadham	iir appa dham
ஈரோடு	iiroodu	iir oodu
ஈரோட்டில்	iiroottil	iir oott il
உங்களை	ungalai	un gal ai
உச்சநீதிமன்றத்தில்	uchchaniidhimanraththil	uchcha niidhi manra ththil
உடல்களை	udalkalai	udal kal ai
உடனடி	udanadi	udan adi
உடனடியாக	udanadiyaaha	udan adi yaaha
உடனே	udanee	udan ee
உடன்	udan	udan
உடுமலை	udumalai	udu malai
உடைந்தது	udaindhadhu	udai ndha dhu
உடைந்து	udaindhu	udai ndhu
உடைந்துள்ளன	udaindhullana	udai ndhu llana
உடைப்பு	udaippu	udai ppu
உட்கட்டமைப்பு	utkattamaippu	ut katta mai ppu
உட்பட	utpada	ut pada
உட்பட்ட	utpatta	ut pa tta
உணரப்பட்டதாகவும்	unarappattadhaahavum	una rapp atta dhaaha vum
உணரப்பட்டது	unarappattadhu	una rapp atta dhu
உணர்ந்ததும்	unarndhadhum	una rndha dhum
உணவு	unavu	unavu
உண்டு	untu	untu
உதவ	udhava	udhava
உதவி	udhavi	udhavi
உதவிகளை	udhavihalai	udhavi hal ai
உதவிகளைப்	udhavihalaip	udhavi hal ai p
உதவியை	udhaviyai	udhavi yai
உதவியையும்	udhaviyaiyum	udhavi yai yum
உதவும்	udhavum	udhavu m
உதவும்படி	udhavumbadi	udhavu m badi
உத்தரவிட்டுள்ளார்	uththaravittullaar	uththa rav ittu llaar
உத்தரவு	uththaravu	uththa ravu
உத்தரவும்	uththaravum	uththa ravu m
உத்தியோகபூர்வமாக	uththiyoohabuurvamaaha	uththi yooha buurvam aaha
உபரி	ubari	ubari
உயரத்துக்கு	uyaraththukku	uyara ththu kku
உயரமான	uyaramaana	uyara maana
உயர்	uyar	uyar
உயர்வு	uyarvu	uyarvu
உயிரிழக்கவும்	uyirizakkavum	uyir izakka vum
உயிரிழந்தனர்	uyirizandhanar	uyir izandh anar
உயிரிழந்தார்	uyirizandhaar	uyir izandh aar
உயிரிழந்துள்ளதாக	uyirizandhulladhaaha	uyir izandh ulladha aha
உயிரிழந்துள்ளனர்	uyirizandhullanar	uyir izandhu llan ar
உயிருடன்	uyirudan	uyir udan
உயிர்	uyir	uyir
உரம்	uram	uram
உரிய	uriya	uriya
உருவாகி	uruvaahi	uru vaahi
உருவாகியுள்ள	uruvaahiyulla	uru vaahi yulla
உரை	urai	urai
உலகப்	ulahap	ulaha p
உலகம்	ulaham	ulaha m
உலகிலேயே	ulahileeyee	ulah il eeyee
உலகில்	ulahil	ulah il
உலகின்	ulahin	ulah in
உலுக்கிய	ulukkiya	ulukki ya
உழைத்த	uzaiththa	uzai ththa
உள்நாட்டு	ulnaattu	ul naattu
உள்பட	ulpada	ul pada
உள்ளதா	ulladhaa	ull adhaa
உள்ளதாக	ulladhaaha	ull adhaa ha
உள்ளது	ulladhu	ull adhu
உள்ளனர்	ullanar	ull anar
உள்ளாகினர்	ullaahinar	ull aahi nar
உள்ளிட்ட	ullitta	ull itta
உள்ளூர்	ulluur	ull uur
உறுதி	urudhi	uru dhi
உறுதியாக	urudhiyaaha	uru dhi yaaha
உறுப்பினர்	uruppinar	uru ppi nar
உறுப்பினர்களையும்	uruppinarkalaiyum	uru ppi nar kal ai yum
உறுப்பு	uruppu	uru ppu
உற்பத்தி	urpaththi	ur paththi
உற்பத்தியில்	urpaththiyil	ur paththi yil
உன்	un	un
ஊசி	uusi	uusi
ஊடகங்கள்	uudahangal	uuda ha<n> gal
ஊடகப்	uudahap	uuda ha p
ஊடாக	uudaaha	uuda aha
ஊழியர்களின்	uuziyarkalin	uuziyar kal in
ஊற்றிய	uutriya	uutr iya
ஊற்றுவதாக	uutruvadhaaha	uutr uvadh aaha
எகிப்தில்	ehipthil	ehi pth il
எகிப்து	ehipthu	ehi pthu
எங்க	enga	en ga
எங்களுக்கு	engalukku	en ga lukku
எங்கள்	engal	en gal
எங்கு	engu	en gu
எச்சரிக்கை	echcharikkai	echch arikkai
எச்சரிக்கையாக	echcharikkaiyaaha	echch arikkai yaaha
எச்சரிக்கையால்	echcharikkaiyaal	echch arikkai yaal
எடுக்குமாறு	edukkumaaru	edu kkum aaru
எடுத்து	eduththu	edu ththu
எடுத்துச்	eduththuch	edu ththu ch
எண்ணக்கை	ennakkai	enna kkai
எண்ணி	enni	enni
எண்ணிக்கையை	ennikkaiyai	enni kkai yai
எண்ணெய்	enney	enney
எதிராக	edhiraaha	edhir aaha
எதிரான	edhiraana	edhir aana
எதிரே	edhiree	edhir ee
எதிரொலியாக	edhiroliyaaha	edhir oli yaaha
எதிர்காலத்தில்	edhirkaalaththil	edhir kaala ththil
எதிர்கொள்ள	edhirkolla	edhir kolla
எதிர்பார்க்கப்படுகிறது	edhirpaarkkappaduhiradhu	edhir paarkka ppadu hir adhu
எதிர்பார்க்கப்பட்டது	edhirpaarkkappattadhu	edhir paarkka ppatta dhu
எதிர்பார்க்காத	edhirpaarkkaadha	edhir paarkka adha
எதிர்வரும்	edhirvarum	edhir varum
எது	edhu	edhu
எதுவும்	edhuvum	edhu vum
எந்த	endha	endha
எந்தவித	endhavidha	endha vidha
எந்திர	endhira	endhira
எபோலாவை	eboolaavai	eboolaa vai
எப்படி	eppadi	eppadi
எமது	emadhu	emadhu
எரியும்	eriyum	eri yum
எல்	el	el
எல்நினோவிற்கு	elninoovirku	el ninoo virku
எல்லாம்	ellaam	ell aam
எல்லைக்	ellaik	ell ai k
எல்லைப்	ellaip	ell ai p
எளிதில்	elidhil	eli dhil
என	ena	ena
எனக்	enak	ena k
எனக்கு	enakku	ena kku
எனச்	enach	ena ch
எனத்	enath	ena th
எனவும்	enavum	enavum
எனவே	enavee	ena vee
எனும்	enum	enu m
என்கிற	engira	en gi ra
என்கிறார்கள்	engiraarkal	en gi raar kal
என்பதற்கும்	enbadharkum	en badhar kum
என்பதால்	enbadhaal	en badh aal
என்பதே	enbadhee	en badhee
என்பதையும்	enbadhaiyum	en badhai yum
என்பவர்	enbavar	en ba var
என்பன	enbana	en bana
என்பார்கள்	enbaarkal	en baar kal
என்ற	enra	en ra
என்றார்	enraar	en ra ar
என்றாலும்	enraalum	en raa lum
என்றால்	enraal	en raal
என்று	enru	en ru
என்றும்	enrum	en rum
என்ன	enna	enna
ஏதும்	eedhum	eedhum
ஏராளமானோர்	eeraalamaanoor	eeraalam aanoor
ஏராளம்	eeraalam	eeraalam
ஏரி	eeri	eeri
ஏரிகள்	eerihal	eeri hal
ஏழு	eezu	eezu
ஏறக்குறைய	eerakkuraiya	eera kkuraiya
ஏற்ப	eerpa	eer pa
ஏற்பட	eerpada	eer pada
ஏற்படலாம்	eerpadalaam	eer padala am
ஏற்படவில்லை	eerpadavillai	eer pada vill ai
ஏற்படுகிறது	eerpaduhiradhu	eer padu hir adhu
ஏற்படுமா	eerpadumaa	eer padu maa
ஏற்படும்	eerpadum	eer padum
ஏற்படுவதை	eerpaduvadhai	eer pad uva dhai
ஏற்பட்ட	eerpatta	eer patta
ஏற்பட்டதாக	eerpattadhaaha	eer pattadha aha
ஏற்பட்டதுடன்	eerpattadhudan	eer patta dhudan
ஏற்பட்டால்	eerpattaal	eer patt aal
ஏற்பட்டு	eerpattu	eer pattu
ஏற்பட்டுள்ள	eerpattulla	eer pattu lla
ஏற்பட்டுள்ளதாக	eerpattulladhaaha	eer patt ulladha aha
ஏற்பட்டுள்ளது	eerpattulladhu	eer patt ulladhu
ஏற்பட்டுள்ளன	eerpattullana	eer patt ullana
ஏற்பாடு	eerpaadu	eer paadu
ஏற்பாடுகள்	eerpaaduhal	eer paadu hal
ஏனெனில்	eenenil	een enil
ஏன்	een	een
ஐந்து	aindhu	aindhu
ஐரோப்பிய	airooppiya	ai roopp iya
ஒதுக்கி	odhukki	odhu kki
ஒதுக்கீடு	odhukkiidu	odhu kkiidu
ஒத்துழைப்பை	oththuzaippai	oththu zai ppai
ஒப்பந்தம்	oppandham	opp an dham
ஒரு	oru	oru
ஒருவர்	oruvar	oru var
ஒலிக்கப்பட்டு	olikkappattu	olikka ppattu
ஒழிப்பு	ozippu	ozi ppu
ஒன்றாக	onraaha	on raaha
ஒன்றான	onraana	on raana
ஒன்றில்	onril	on ril
ஒன்றினைந்து	onrinaindhu	on rinai ndhu
ஒன்றின்	onrin	on rin
ஒன்னு	onnu	on nu
ஓசூர்	oosuur	oos uur
ஓடியது	oodiyadhu	oodi yadhu
ஓடும்	oodum	oodu m
ஓட்டு	oottu	oottu
ஓர்	oor	oor
கடக்கும்	kadakkum	kada kkum
கடந்த	kadandha	kada ndha
கடந்தது	kadandhadhu	kada ndha dhu
கடந்து	kadandhu	kada ndhu
கடமை	kadamai	kada mai
கடலடி	kadaladi	kada ladi
கடலுக்கு	kadalukku	kada lukku
கடலோர	kadaloora	kada loora
கடல்	kadal	kada l
கடவுளே	kadavulee	kada vulee
கடற்கரை	kadarkarai	kadar karai
கடற்கரைச்	kadarkaraich	kadar karai ch
கடற்கரையில்	kadarkaraiyil	kadar karai yil
கடற்படை	kadarpadai	kadar padai
கடற்படைக்குச்	kadarpadaikkuch	kadar padai kku ch
கடிதங்கள்	kadidhangal	kadi dha<n> gal
கடிதம்	kadidham	kadi dham
கடுமையாக	kadumaiyaaha	kadu mai yaaha
கடுமையானது	kadumaiyaanadhu	kadu mai yaana dhu
கட்சியின்	katchiyin	katchi yin
கட்டடங்கள்	kattadangal	katta da<n> gal
கட்டப்பட்ட	kattappatta	katta ppatta
கட்டி	katti	katti
கட்டிடக்கலை	kattidakkalai	katti dakka lai
கட்டிடங்கள்	kattidangal	katti da<n> gal
கட்டுப்படுத்த	kattuppaduththa	kattu ppadu ththa
கட்டுமானப்	kattumaanap	kattu maana p
கட்டும்	kattum	kattu m
கணக்கெடுப்பு	kanakkeduppu	kana kkeduppu
கணப்பொழுதில்	kanappozudhil	kana ppozudh il
கண்	kan	kan
கண்காணித்து	kankaaniththu	kan kaani ththu
கண்டி	kanti	kanti
கண்ணீர்	kanniir	kann iir
கதவுகள்	kadhavuhal	kadhavu hal
கதிரியக்கம்	kadhiriyakkam	kadhir iyakkam
கதிர்வீச்சு	kadhirviichchu	kadhir viichchu
கப்பலில்	kappalil	kappal il
கப்பலும்	kappalum	kappal um
கப்பல்	kappal	kappal
கப்பல்களும்	kappalkalum	kappal kal um
கப்பல்களை	kappalkalai	kappal kal ai
கருதி	karudhi	karu dhi
கருத்து	karuththu	karu ththu
கரூர்	karuur	karu ur
கரை	karai	karai
கரைபுரண்டு	karaiburantu	karai burantu
கரையில்	karaiyil	karai yil
கரையை	karaiyai	karai yai
கரையைக்	karaiyaik	karai yai k
கரையோர	karaiyoora	karai yoora
கரையோரத்தை	karaiyooraththai	karai yoora thth ai
கரையோரப்	karaiyoorap	karai yoora p
கர்நாடக	karnaadaha	kar naa daha
கலந்து	kalandhu	kal andhu
கலவரம்	kalavaram	kal avaram
கலெக்டராக	kalektaraaha	kal ektar aaha
கலெக்டர்களுக்கு	kalektarkalukku	kal ektar kal ukku
கல்முனை	kalmunai	kal munai
கல்லூரி	kalluuri	kall uuri
கல்விக்	kalvik	kalvi k
கவனத்திற்கு	kavanaththirku	kavana ththirku
கவனம்	kavanam	kavana m
கவனிக்க	kavanikka	kavani kka
கவிதை	kavidhai	kavi dhai
கழிமுக	kazimuha	kazi muha
கழிவு	kazivu	kazi vu
கழிவுகளை	kazivuhalai	kazi vuha lai
கழுத்து	kazuththu	kazu ththu
கழுவுதல்	kazuvudhal	kazu vudhal
களை	kalai	kalai
கறுப்பு	karuppu	karuppu
கன	kana	kana
கனமழையால்	kanamazaiyaal	kana mazai yaal
கனவுகளை	kanavuhalai	kanavu hal ai
கன்னியாகுமரி	kanniyaahumari	kanni yaa humari
காக்கிறது	kaakkiradhu	kaakk iradhu
காங்கிரஸின்	kaangirasin	kaan giras in
காஞ்சி	kaanji	kaan ji
காஞ்சிபுரம்	kaanjiburam	kaan ji buram
காட்சி	kaatchi	kaatchi
காட்டில்	kaattil	kaatt il
காட்டுக்கு	kaattukku	kaattu kku
காட்டுத்	kaattuth	kaattu th
காண	kaana	kaana
காணக்கூடியதாக	kaanakkuudiyadhaaha	kaana kkuudiya dhaaha
காணக்கூடியதாகவிருந்தது	kaanakkuudiyadhaahavirundhadhu	kaana kkuudiya dhaaha virundh adhu
காணப்படும்	kaanappadum	kaana ppadum
காணாத	kaanaadha	kaan aadha
காணாமல்	kaanaamal	kaan aamal
காண்க	kaanka	kaan ka
காதல்	kaadhal	kaadhal
காத்திருக்கும்	kaaththirukkum	kaathth irukkum
காப்பாற்றப்பட்டனர்	kaappaatrappattanar	kaappaatra ppatta nar
காயமடைந்து	kaayamadaindhu	kaayam adaindhu
காயமுற்றனர்	kaayamutranar	kaaya mutra nar
காய்ச்சலால்	kaaychchalaal	kaay chchal aal
காய்ச்சல்	kaaychchal	kaay chchal
காரணமாக	kaaranamaaha	kaaranam aaha
காரணம்	kaaranam	kaaranam
கால	kaala	kaala
காலநிலை	kaalanilai	kaala nilai
காலம்	kaalam	kaala m
காலுடன்	kaaludan	kaal udan
காலே	kaalee	kaal ee
காலை	kaalai	kaal ai
கால்	kaal	kaal
கால்பந்து	kaalpandhu	kaal pandhu
கால்வாய்கள்	kaalvaaykal	kaal vaay kal
காற்றாலைகள்	kaatraalaihal	kaatr aalai hal
காற்றினால்	kaatrinaal	kaatr inaal
காற்றின்	kaatrin	kaatr in
காற்று	kaatru	kaatr u
காற்றுடன்	kaatrudan	kaatr udan
காஷ்மீரில்	kaashmiiril	kaashmiir il
காஷ்மீரின்	kaashmiirin	kaashmiir in
காஷ்மீர்	kaashmiir	kaashmiir
கிடப்பில்	kidappil	kidapp il
கிடைக்கும்	kidaikkum	kidai kkum
கிடைத்த	kidaiththa	kidai ththa
கிட்டத்தட்ட	kittaththatta	kitta ththatta
கிராமங்களிலும்	kiraamangalilum	kiraama<n> gal il um
கிராமங்கள்	kiraamangal	kiraama<n> gal
கிராமம்	kiraamam	kiraamam
கிருமிகள்	kirumihal	kirumi hal
கிழக்கு	kizakku	kizakku
கிழக்குக்	kizakkuk	kizakku k
கிழக்கே	kizakkee	kizakk ee
கிளிநொச்சியில்	kilinochchiyil	kili nochchi yil
கிளை	kilai	kilai
கிளையின்	kilaiyin	kilai yin
கீழே	kiizee	kiizee
கீழ்	kiizh	kiizh
குடிசைகள்	kudisaihal	kudi sai hal
குடியிருக்கும்	kudiyirukkum	kudi yir ukkum
குடியிருப்பு	kudiyiruppu	kudi yir uppu
குடும்ப	kudumba	kudumba
குடும்பங்களுக்கு	kudumbangalukku	kudumba<n> gal ukku
குடும்பங்களுக்கும்	kudumbangalukkum	kudumba<n> gal ukk um
குடும்பங்களைச்	kudumbangalaich	kudumba<n> gal ai ch
குடும்பங்கள்	kudumbangal	kudumba<n> gal
குடும்பத்தினர்	kudumbaththinar	kudumba ththin ar
குண்டு	kuntu	kuntu
குமிழி	kumizi	kumizi
குழந்தைகளுக்கு	kuzandhaihalukku	kuzandhai hal ukku
குழந்தைகள்	kuzandhaihal	kuzandhai hal
குழுமத்தின்	kuzumaththin	kuzu mathth in
குழுவில்	kuzuvil	kuzu vil
குழுவினர்	kuzuvinar	kuzu vi nar
குழுவின்	kuzuvin	kuzu vin
குழுவும்	kuzuvum	kuzu vum
குழுவை	kuzuvai	kuzu vai
குழுவையும்	kuzuvaiyum	kuzu vai yum
குளங்களில்	kulangalil	kula<n> gal il
குளம்	kulam	kula m
குளிர்ந்த	kulirndha	kulir ndha
குறிக்கின்றது	kurikkinradhu	kuri kkin radhu
குறித்த	kuriththa	kuri ththa
குறித்து	kuriththu	kuri ththu
குறிப்பாக	kurippaaha	kuri ppaaha
குறிப்பிடத்தக்கது	kurippidaththakkadhu	kuri ppida ththakk adhu
குறிப்பிட்ட	kurippitta	kuri ppitta
குறிப்பிட்டார்	kurippittaar	kuri ppitt aar
குறைந்த	kuraindha	kurain dha
குறைந்தது	kuraindhadhu	kurain dhadhu
குறைந்து	kuraindhu	kurain dhu
குறைவாக	kuraivaaha	kurai vaaha
குற்றச்சாட்டுக்களை	kutrachchaattukkalai	kutra chchaattu kkal ai
குற்றம்	kutram	kutram
குஜராத்தில்	kujaraaththil	kujaraathth il
கூட	kuuda	kuuda
கூடவே	kuudavee	kuuda vee
கூடாது	kuudaadhu	kuudaa dhu
கூடிய	kuudiya	kuudiya
கூடுதலாக	kuududhalaaha	kuudu dhal aaha
கூடுதல்	kuududhal	kuudu dhal
கூடும்	kuudum	kuudu m
கூட்டத்தில்	kuuttaththil	kuutta ththil
கூட்டம்	kuuttam	kuutta m
கூட்டுறவு	kuutturavu	kuutt uravu
கூரைகளும்	kuuraihalum	kuurai hal um
கூரைகள்	kuuraihal	kuurai hal
கூறப்படுகிறது	kuurappaduhiradhu	kuura ppadu hir adhu
கூறப்பட்டுள்ளது	kuurappattulladhu	kuura ppatt ull adhu
கூறிச்	kuurich	kuuri ch
கூறியதாவது	kuuriyadhaavadhu	kuuri yadhaav adhu
கூறியது	kuuriyadhu	kuuri ya dhu
கூறியதை	kuuriyadhai	kuuri ya dhai
கூறியிருந்தது	kuuriyirundhadhu	kuuri yirundh adhu
கூறியுள்ளார்	kuuriyullaar	kuuri yull aar
கூறுகையில்	kuuruhaiyil	kuuru hai yil
கேட்கும்	keetkum	keet kum
கேட்ட	keetta	keett a
கேட்டுக்	keettuk	keettu k
கேட்டுக்கொண்டார்	keettukkontaar	keettu kkont aar
கேரளா	keeralaa	keera laa
கேரளாவில்	keeralaavil	keera laavil
கை	kai	kai
கைது	kaidhu	kai dhu
கையில்	kaiyil	kai yil
கொடுத்து	koduththu	kodu ththu
கொடுத்துப்	koduththup	kodu ththu p
கொடுமை	kodumai	kodumai
கொட்டும்	kottum	kottum
கொண்ட	konta	konta
கொண்டதாக	kontadhaaha	konta dhaaha
கொண்டனர்	kontanar	konta n ar
கொண்டிருக்கும்	kontirukkum	kont irukkum
கொண்டிருந்த	kontirundha	kont irundha
கொண்டிருந்தது	kontirundhadhu	kont irundh adhu
கொண்டு	kontu	kont u
கொண்டும்	kontum	kontu m
கொண்டுள்ளது	kontulladhu	kontu ll adhu
கொண்டுள்ளனர்	kontullanar	kontu lla nar
கொண்டே	kontee	kont ee
கொலை	kolai	kolai
கொழுந்து	kozundhu	kozu ndhu
கொழும்பிலும்	kozumbilum	kozu mbi lum
கொள்கிறது	kolkiradhu	kol kir adhu
கொள்கிறேன்	kolkireen	kol kir een
கொள்கிறோம்	kolkiroom	kol kir oom
கொள்ள	kolla	koll a
கொள்ளலாம்	kollalaam	koll al aam
கொள்ளுங்கள்	kollungal	kollu<n> gal
கொள்ளும்	kollum	kollum
கோடி	koodi	koodi
கோடிகள்	koodihal	koodi hal
கோடை	koodai	koodai
கோட்டுக்கு	koottukku	koottu kku
கோரிக்கை	koorikkai	koori kkai
கோரிக்கைகளை	koorikkaihalai	koori kkai hal ai
கோலில்	koolil	kool il
கோவை	koovai	koovai
சகல	chahala	chah ala
சகோதரர்	chahoodharar	chah oodharar
சகோதர்களே	chahoodharkalee	chah oodhar kal ee
சங்கம்	changam	changam
சங்கு	changu	changu
சடலங்கள்	chadalangal	chadala<n> gal
சடலமாக	chadalamaaha	chadala maaha
சட்டஅமைச்சர்	chattaamaichchar	chatta amai chchar
சட்டம்	chattam	chatta m
சட்டவிரோத	chattaviroodha	chatta viroodha
சந்த	chandha	chandha
சந்திக்கும்	chandhikkum	chandhi kkum
சந்தித்து	chandhiththu	chandhi ththu
சந்தித்துப்	chandhiththup	chandhi ththu p
சபை	chabai	chabai
சப்பாத்து	chappaaththu	chapp aaththu
சமய	chamaya	chama ya
சமயம்	chamayam	chama yam
சமுத்திரம்	chamuththiram	chamu ththir am
சமூகத்தினர்	chamuuhaththinar	chamuu ha ththi nar
சமூகத்தினை	chamuuhaththinai	chamuu ha ththi nai
சம்பவ	chambava	cham bava
சம்பவம்	chambavam	cham bava m
சரி	chari	chari
சரிந்தன	charindhana	chari ndhana
சரிந்து	charindhu	chari ndhu
சரியாக	chariyaaha	chari yaaha
சரியான	chariyaana	chari yaana
சரிவில்	charivil	chari vil
சரிவு	charivu	chari vu
சர்வதேச	charvadheesa	char vadheesa
சளி	chali	chali
சற்று	chatru	chatru
சனிக்கிழமை	chanikkizamai	chani kkiza mai
சனிக்கிழமையன்று	chanikkizamaiyanru	chani kkiza mai yanru
சாக்கடை	chaakkadai	chaa kk adai
சாதனை	chaadhanai	chaa dhanai
சாதாரண	chaadhaarana	chaa dhaarana
சாரதிகள்	chaaradhihal	chaa radhi hal
சார்பில்	chaarpil	chaa rpil
சாலை	chaalai	chaalai
சாலைகளிலும்	chaalaihalilum	chaalai hal il um
சாலைகளில்	chaalaihalil	chaalai hal il
சாலைகள்	chaalaihal	chaalai hal
சாலையில்	chaalaiyil	chaalai yil
சாவு	chaavu	chaavu
சிகிச்சை	chihichchai	chihichchai
சிகிச்சைகள்	chihichchaihal	chihichchai hal
சிக்கி	chikki	chikki
சிக்கிக்கொண்டனர்	chikkikkontanar	chikki kkonta nar
சிதறுண்டு	chidharuntu	chidhar untu
சில	chila	chila
சிலர்	chilar	chila r
சிவப்பு	chivappu	chivappu
சிறிலங்காவின்	chirilangaavin	chiri langaa vin
சிறு	chiru	chiru
சீரமைக்க	chiiramaikka	chiira maikka
சீரற்ற	chiiratra	chiira tra
சீற்றத்தால்	chiitraththaal	chiitra ththaal
சீனாவில்	chiinaavil	chiinaa vil
சீனாவின்	chiinaavin	chiinaa vin
சீனாவும்	chiinaavum	chiinaa vum
சுகாதார	chuhaadhaara	chuhaa dhaara
சுகாதாரத்	chuhaadhaarath	chuhaa dhaara th
சுகாதாரப்	chuhaadhaarap	chuhaa dhaara p
சுதந்திரம்	chudhandhiram	chudha ndhiram
சுமத்த	chumaththa	chuma ththa
சுமத்துகின்றனர்	chumaththuhinranar	chuma ththu hinra nar
சுமத்ரா	chumathraa	chuma thraa
சுமார்	chumaar	chumaa r
சுரங்கத்தின்	churangaththin	churanga ththin
சுரங்கப்	churangap	churanga p
சுரங்கம்	churangam	churanga m
சுரத்துடன்	churaththudan	churathth udan
சுவாச	chuvaasa	chuvaasa
சுற்றியுள்ள	chutriyulla	chutri yulla
சுற்று	chutru	chutru
சுற்றுச்	chutruch	chutru ch
சுற்றுலா	chutrulaa	chutru laa
சுற்றுலாப்	chutrulaap	chutru laa p
சுனமியை	chunamiyai	chunami yai
சுனாமியால்	chunaamiyaal	chunaami yaal
சூரிய	chuuriya	chuuri ya
சூரியன்	chuuriyan	chuuri yan
சூரைக்காற்றுடன்	chuuraikkaatrudan	chuurai kkaatr udan
சூழல்	chuuzal	chuuz al
சூழ்ந்துள்ளது	chuuzhndhulladhu	chuuzh ndhull adhu
சூறாவளியில்	chuuraavaliyil	chuuraa vali yil
சூறை	chuurai	chuurai
செஞ்சிலுவை	chenjiluvai	chen <j>iluvai
செயலர்	cheyalar	chey al ar
செயலாளர்	cheyalaalar	chey al aalar
செயலாளர்கள்	cheyalaalarkal	chey al aal ar kal
செயல்பட்டு	cheyalpattu	chey al pattu
செய்கிறது	cheykiradhu	chey kir adhu
செய்த	cheytha	chey tha
செய்தது	cheythadhu	chey th adhu
செய்தார்	cheythaar	chey th aar
செய்தால்	cheythaal	chey th aal
செய்தி	cheythi	chey thi
செய்திகள்	cheythihal	chey thi hal
செய்தித்	cheythith	chey thi th
செய்தியாளர்	cheythiyaalar	chey thi yaalar
செய்தியைக்	cheythiyaik	chey thi yai k
செய்து	cheythu	chey thu
செய்துள்ள	cheythulla	chey thulla
செய்துள்ளது	cheythulladhu	chey thulla dhu
செய்ய	cheyya	cheyya
செய்யப்படும்	cheyyappadum	cheyya ppad um
செய்யப்பட்டது	cheyyappattadhu	cheyya ppatta dhu
செய்யப்பட்டு	cheyyappattu	cheyya ppattu
செய்யப்பட்டுள்ளதாகவும்	cheyyappattulladhaahavum	cheyya ppatt ulla dhaa ha vum
செய்யப்பட்டுள்ளன	cheyyappattullana	cheyya ppatt ullana
செய்வது	cheyvadhu	chey vadhu
செர்னோபிலுக்கு	chernoobilukku	cher noobil ukku
செலவு	chelavu	chelavu
செலுத்தி	cheluththi	chelu ththi
செல்ல	chella	chella
செல்லப்பட்ட	chellappatta	chella ppatta
செல்லுமாறு	chellumaaru	chellu maaru
செல்வதால்	chelvadhaal	chel vadh aal
செல்வது	chelvadhu	chel vadhu
செவிலியர்கள்	cheviliyarkal	cheviliyar kal
சென்ற	chenra	chenra
சென்று	chenru	chenru
சென்றுள்ளன	chenrullana	chenru llana
சென்னைக்கு	chennaikku	chennai kku
சென்னைக்கும்	chennaikkum	chennai kkum
சென்னையில்	chennaiyil	chennai yil
சென்னையை	chennaiyai	chennai yai
சேதங்களை	cheedhangalai	cheedha<n> gal ai
சேதங்கள்	cheedhangal	cheedha<n> gal
சேதத்துக்குள்ளானது	cheedhaththukkullaanadhu	cheedha ththu kkulla anadhu
சேதத்தை	cheedhaththai	cheedha ththai
சேதமடைந்த	cheedhamadaindha	cheedham adaindh a
சேதமடைந்தன	cheedhamadaindhana	cheedham adaindh ana
சேதமடைந்துள்ளன	cheedhamadaindhullana	cheedham adaindh ullana
சேதமாகின	cheedhamaahina	cheedha maahina
சேமிக்கும்	cheemikkum	cheemi kkum
சேர்த்து	cheerththu	cheer ththu
சேர்ந்த	cheerndha	cheer ndha
சேர்ந்தது	cheerndhadhu	cheer ndha dhu
சேர்ந்து	cheerndhu	cheer ndhu
சேவை	cheevai	cheevai
சேவைகளை	cheevaihalai	cheevai hal ai
சேவைகள்	cheevaihal	cheevai hal
சொந்தமான	chondhamaana	chondham aana
சொல்	chol	chol
சொல்லி	cholli	choll i
சோதி	choodhi	choodhi
சோர்வு	choorvu	choorvu
ஞாயிறன்று	nyaayiranru	nyaayir anru
ஞாயிற்றுக்கிழமை	nyaayitrukkizamai	nyaayitr ukkiz amai
டிசம்பரில்	tisambaril	tisambar il
டெங்கு	tengu	tengu
டெல்லிக்கு	tellikku	telli kku
டெல்லியில்	telliyil	telli yil
தகவல்	thahaval	thahaval
தகவல்களை	thahavalkalai	thahaval kal ai
தங்க	thanga	tha<n>ga
தங்களது	thangaladhu	tha<n>ga ladhu
தங்கள்	thangal	tha<n> gal
தஞ்சம்	thanjam	thanjam
தடவை	thadavai	thadavai
தடுக்க	thadukka	thad ukka
தடுப்பு	thaduppu	thad uppu
தடுப்புக்	thaduppuk	thad uppu k
தடை	thadai	thadai
தண்ணீரை	thanniirai	thannii rai
தண்ணீர்	thanniir	thannii r
தந்த	thandha	thandha
தப்பிக்க	thappikka	thappi kka
தமது	thamadhu	tham adhu
தமிழக	thamizaha	thamiz aha
தமிழகத்தில்	thamizahaththil	thamiz aha thth il
தமிழகத்தின்	thamizahaththin	thamiz aha thth in
தமிழகத்துக்கு	thamizahaththukku	thamiz aha thth ukku
தமிழகத்தை	thamizahaththai	thamiz aha thth ai
தமிழகம்	thamizaham	thamiz aham
தமிழர்	thamizar	thamiz ar
தமிழர்களை	thamizarkalai	thamiza r kal ai
தமிழர்கள்	thamizarkal	thamiz ar kal
தமிழ்	thamizh	thamizh
தமிழ்நாடு	thamizhnaadu	thamizh naadu
தமிழ்நாட்டில்	thamizhnaattil	thamizh naatt il
தமிழ்நாட்டுக்கு	thamizhnaattukku	thamizh naattu kku
தமிழ்நாட்டுக்குத்	thamizhnaattukkuth	thamizh naattu kku th
தமிழ்நாட்ல	thamizhnaatla	thamizh naat la
தயாரிக்கப்பட்டு	thayaarikkappattu	thayaar ikka ppattu
தயார்	thayaar	thayaar
தயார்நிலையில்	thayaarnilaiyil	thayaar nilai yil
தர	thara	thara
தரப்படும்	tharappadum	thara ppa dum
தரப்பு	tharappu	thara ppu
தருகிறார்	tharuhiraar	tharu hira ar
தரை	tharai	thar ai
தலா	thalaa	thalaa
தலைநகர்	thalainahar	thalai nahar
தலைப்பில்	thalaippil	thalai ppil
தலைமை	thalaimai	thalai mai
தலைவர்	thalaivar	thalai var
தலைவர்கள்	thalaivarkal	thalai var kal
தவறிய	thavariya	thava riya
தவிக்கும்	thavikkum	thavi kkum
தவித்து	thaviththu	thavi ththu
தவிர	thavira	thavi ra
தவிர்க்க	thavirkka	thavi rkka
தவிர்த்தல்	thavirththal	thavi rththal
தவிர்த்துக்	thavirththuk	thavi rththu k
தளத்தில்	thalaththil	thala ththil
தள்ளி	thalli	thalli
தள்ளுபடி	thallubadi	thallu badi
தற்காலிக	tharkaaliha	thar kaal iha
தற்காலிகமாக	tharkaalihamaaha	thar kaal iha maaha
தற்கொலை	tharkolai	thar kolai
தற்கொலைக்கு	tharkolaikku	thar kolai kku
தற்போது	tharpoodhu	thar poodhu
தனது	thanadhu	than adhu
தனியார்	thaniyaar	thani yaar
தன்மை	thanmai	than mai
தாக்கத்திலிருந்து	thaakkaththilirundhu	thaakka ththil irundhu
தாக்கத்திற்கு	thaakkaththirku	thaakka thth irku
தாக்கத்திற்கும்	thaakkaththirkum	thaakka ththir kum
தாக்கம்	thaakkam	thaakka m
தாக்கல்	thaakkal	thaakka l
தாக்கிய	thaakkiya	thaakki ya
தாக்கியதில்	thaakkiyadhil	thaakki yadhil
தாக்கியது	thaakkiyadhu	thaakki yadhu
தாக்குதல்	thaakkudhal	thaakku dhal
தாங்க	thaanga	thaanga
தாண்டி	thaanti	thaanti
தாமிரபரணி	thaamirabarani	thaamira barani
தாய்லாந்து	thaaylaandhu	thaay laandhu
தாழ்வான	thaazhvaana	thaazh vaana
தாழ்வு	thaazhvu	thaazh vu
திகதி	thihadhi	thi hadhi
திங்கள்கிழமை	thingalkizamai	thi ngal kizamai
திசை	thisai	thi sai
திடீரென	thidiirena	thi diir ena
திடீரென்று	thidiirenru	thi diir enru
திடீர்	thidiir	thi diir
திட்டங்களில்	thittangalil	thitta<n> gal il
திட்டங்களையும்	thittangalaiyum	thitta<n> gal ai yum
திட்டத்தின்	thittaththin	thitta ththin
திட்டத்தை	thittaththai	thitta ththai
திணைக்களத்தின்	thinaikkalaththin	thinai kkala ththin
திணைக்களம்	thinaikkalam	thinai kkalam
திரு	thiru	thiru
திருப்பி	thiruppi	thiru ppi
திருவள்ளூர்	thiruvalluur	thiru valluur
தில்லியில்	thilliyil	thilli yil
திறந்து	thirandhu	thi randhu
தினங்களில்	thinangalil	thi na<n> gal il
தினங்களுக்கு	thinangalukku	thi na<n> gal ukku
தினத்தை	thinaththai	thi na ththai
தினமும்	thinamum	thi nam um
தீயை	thiiyai	thii yai
தீர்ப்பு	thiirppu	thii rppu
தீவிர	thiivira	thii vira
தீவிரப்	thiivirap	thii vira p
தீவிரம்	thiiviram	thii vir am
தீவில்	thiivil	thii vil
தீவின்	thiivin	thii vin
தீவுகளில்	thiivuhalil	thii vuhal il
தீவுகள்	thiivuhal	thii vuhal
துணை	thunai	thunai
துணைபுரியும்	thunaiburiyum	thunai buriyum
துண்டிக்கப்பட்டது	thuntikkappattadhu	thun tikka ppatt adhu
துண்டிக்கப்பட்டுள்ளது	thuntikkappattulladhu	thun tikka ppatt ulladhu
தும்மல்	thummal	thummal
துயர்துடைப்பு	thuyarthudaippu	thuyar thudaippu
துரித	thuridha	thuridha
துவங்கியது	thuvangiyadhu	thuva<n> giya dhu
துவங்கும்	thuvangum	thuva<n> gum
துறை	thurai	thurai
துறைகளில்	thuraihalil	thurai hal il
துறைமுகத்தில்	thuraimuhaththil	thurai muha thth il
துறைமுகத்துக்கு	thuraimuhaththukku	thurai muha thth ukku
துறைமுகம்	thuraimuham	thurai muham
தூக்கி	thuukki	thuukki
தூரத்தில்	thuuraththil	thuura ththil
தெரிகிறது	therihiradhu	theri hir adhu
தெரியுமா	theriyumaa	theri yum aa
தெரியும்	theriyum	theriy um
தெரிவிக்க	therivikka	theri vikka
தெரிவிக்கப்பட்டது	therivikkappattadhu	theri vikka ppatta dhu
தெரிவிக்கப்பட்டுள்ளது	therivikkappattulladhu	theri vikka ppatt ulladhu
தெரிவிக்கிறது	therivikkiradhu	theri vikki radhu
தெரிவிக்கின்றன	therivikkinrana	theri vikki nrana
தெரிவிக்கின்றனர்	therivikkinranar	theri vikki nra nar
தெரிவித்தது	theriviththadhu	theri vithth adhu
தெரிவித்தார்	theriviththaar	theri vithth aar
தெரிவித்திருந்தார்	theriviththirundhaar	theri vithth irundh aar
தெரிவித்துள்ளது	theriviththulladhu	theri vithth ulladhu
தெரிவித்துள்ளன	theriviththullana	theri vithth ullana
தெரிவித்துள்ளனர்	theriviththullanar	theri vithth ullana r
தெரிவு	therivu	therivu
தெருக்களில்	therukkalil	theru kkal il
தெளிவாக	thelivaaha	theli vaaha
தெளிவான	thelivaana	theli vaana
தெற்கு	therku	ther ku
தென்கிழக்கே	thengizakkee	then gizakk ee
தென்பெண்ணை	thenbennai	then bennai
தென்மேற்கு	thenmeerku	then meerku
தென்மேற்குப்	thenmeerkup	then meerku p
தென்னை	thennai	thenn ai
தேங்கி	theengi	theen gi
தேங்கிய	theengiya	theen gi ya
தேசிய	theesiya	thee si ya
தேடுதல்	theedudhal	theedu dhal
தேதிக்குள்	theedhikkul	theedhi kkul
தேயிலை	theeyilai	thee yilai
தேர்தலில்	theerthalil	thee rthal il
தேர்தல்	theerthal	thee rthal
தேவை	theevai	thee vai
தேவைகளை	theevaihalai	thee vai hal ai
தேவைப்படும்	theevaippadum	thee vai ppadum
தேவையான	theevaiyaana	thee vai yaana
தொகை	thohai	thohai
தொடர	thodara	thodar a
தொடரும்	thodarum	thodar um
தொடர்	thodar	thodar
தொடர்ந்து	thodarndhu	thodar ndhu
தொடர்ந்தும்	thodarndhum	thodar ndhu m
தொடர்பாக	thodarpaaha	thodar pa aha
தொடர்பாளர்	thodarpaalar	thodar paal ar
தொடர்பான	thodarpaana	thodar paana
தொடர்பில்	thodarpil	thodar pil
தொண்டை	thontai	thon tai
தொலைபேசி	tholaibeesi	tholai beesi
தொலைவில்	tholaivil	tholai vil
தொழில்	thozil	thozil
தொழிற்சாலையில்	thozirchaalaiyil	thozir chaalai yil
தொற்று	thotru	thotru
தொற்றுநோய்ப்	thotrunooyp	thotru nooy p
தொற்றும்	thotrum	thotru m
தோட்டங்களில்	thoottangalil	thootta<n> gal il
தோல்	thool	thool
தோன்றும்	thoonrum	thoon rum
நகர	nahara	naha ra
நகரங்களிலும்	naharangalilum	naha ra<n> gal il um
நகரங்களில்	naharangalil	naha ra<n> gal il
நகரத்தில்	naharaththil	naha ra ththil
நகரம்	naharam	naha ram
நகரும்	naharum	naha rum
நகரை	naharai	naha rai
நகர்ந்தால்	naharndhaal	naha rndhaal
நகர்ந்து	naharndhu	naha rndhu
நடக்கும்	nadakkum	nada kkum
நடத்துனர்	nadaththunar	nada ththu nar
நடந்த	nadandha	nada ndha
நடப்புப்	nadappup	nada ppu p
நடமாட	nadamaada	nada maada
நடவடிக்கை	nadavadikkai	nada vadi kkai
நடவடிக்கைகளை	nadavadikkaihalai	nada vadi kkai hal ai
நடவடிக்கைகள்	nadavadikkaihal	nada vadi kkai hal
நடவடிக்கைக்	nadavadikkaik	nada vadi kkai k
நடவடிக்கையாக	nadavadikkaiyaaha	nada vadi kkai yaaha
நடவடிக்கையில்	nadavadikkaiyil	nada vadi kkai yil
நடுக்கம்	nadukkam	nadu kkam
நடைபெறும்	nadaiberum	nadai berum
நடைபெற்றது	nadaibetradhu	nadai betra dhu
நடைபெற்று	nadaibetru	nadai betru
நடைமுறைக்கு	nadaimuraikku	nadai murai kku
நண்பகல்	nanpahal	nan pa hal
நண்பர்கள்	nanparkal	nan par kal
நதி	nadhi	nadhi
நதிகளின்	nadhihalin	nadhi hal in
நதிகளை	nadhihalai	nadhi hal ai
நதிநீர்	nadhiniir	nadhi niir
நமக்கு	namakku	nam akku
நம்	nam	nam
நம்ம	namma	namm a
நம்மை	nammai	namm ai
நலமே	nalamee	nalam ee
நன்கு	nangu	nan gu
நன்றாக	nanraaha	nan raaha
நஷ்டம்	nashtam	nash tam
நாடாளுமன்ற	naadaalumanra	naadaa lu manra
நாடான	naadaana	naadaa na
நாடு	naadu	naadu
நாடுகளின்	naaduhalin	naadu hal in
நாடுகளை	naaduhalai	naadu hal ai
நாடுகள்	naaduhal	naadu hal
நாட்களாக	naatkalaaha	naat kal aaha
நாட்களில்	naatkalil	naat kal il
நாட்களுக்கு	naatkalukku	naat kal ukku
நாட்கள்	naatkal	naat kal
நாட்டின்	naattin	naatt in
நாட்டு	naattu	naatt u
நாம்	naam	naam
நாளாக	naalaaha	naal aaha
நாள்ப்பட்ட	naalppatta	naal ppatta
நானும்	naanum	naan um
நான்கு	naangu	naangu
நிகழும்	nihazum	nihaz um
நிகழ்ச்சி	nihazhchchi	nihazh chchi
நிகழ்த்தினார்	nihazhththinaar	nihazh ththin aar
நிகழ்ந்த	nihazhndha	nihazh ndha
நிகழ்வில்	nihazhvil	nihazh vil
நிகழ்வுகளை	nihazhvuhalai	nihazh vu hal ai
நிகழ்வுகள்	nihazhvuhal	nihazh vu hal
நிதி	nidhi	nidhi
நிதியாக	nidhiyaaha	nidhi yaaha
நிதியுதவி	nidhiyudhavi	nidhi yudhavi
நிபுணத்துவக்	nibunaththuvak	nibuna ththuva k
நிபுணர்	nibunar	nibunar
நிபுணர்கள்	nibunarkal	nibunar kal
நிம்மதி	nimmadhi	nimm adhi
நிரந்தர	nirandhara	nira ndhara
நிரம்பி	nirambi	nira mbi
நிர்வாக	nirvaaha	nir vaaha
நிர்வாகம்	nirvaaham	nir vaaha m
நில	nila	nila
நிலஅதிர்வுகள்	nilaadhirvuhal	nila adhir vu hal
நிலங்கள்	nilangal	nila<n> gal
நிலச்சரிவில்	nilachcharivil	nila chchari vil
நிலச்சரிவினால்	nilachcharivinaal	nila chchari vi naal
நிலச்சரிவு	nilachcharivu	nila chchari vu
நிலத்தில்	nilaththil	nila thth il
நிலநடுக்க	nilanadukka	nila nadu kka
நிலநடுக்கத்தால்	nilanadukkaththaal	nila nadu kka thth aal
நிலநடுக்கத்தின்	nilanadukkaththin	nila nadu kka thth in
நிலநடுக்கத்தை	nilanadukkaththai	nila nadu kka thth ai
நிலம்	nilam	nila m
நிலவரங்கள்	nilavarangal	nila varan gal
நிலவும்	nilavum	nila vum
நிலவுவதால்	nilavuvadhaal	nilavu vadh aal
நிலை	nilai	nilai
நிலைகொண்டுள்ளது	nilaihontulladhu	nilai hont ulladhu
நிலைய	nilaiya	nilai ya
நிலையங்களிலும்	nilaiyangalilum	nilai ya<n> gal il um
நிலையங்களில்	nilaiyangalil	nilai ya<n> gal il
நிலையங்களுக்கும்	nilaiyangalukkum	nilai ya<n> gal ukkum
நிலையங்கள்	nilaiyangal	nilai ya<n> gal
நிலையத்தில்	nilaiyaththil	nilai ya thth il
நிலையத்தின்	nilaiyaththin	nilai ya thth in
நிலையத்தை	nilaiyaththai	nilai ya thth ai
நிலையம்	nilaiyam	nilai ya m
நிலையில்	nilaiyil	nilai yil
நிவாரண	nivaarana	ni vaarana
நிவாரணக்	nivaaranak	ni vaarana k
நிவாரணங்களை	nivaaranangalai	ni vaarana<n> gal ai
நிவாரணங்கள்	nivaaranangal	ni vaarana<n> gal
நிவாரணத்தை	nivaaranaththai	ni vaarana thth ai
நிவாரணப்	nivaaranap	ni vaarana p
நிவாரணமாக	nivaaranamaaha	ni vaarana maaha
நிவாரணம்	nivaaranam	nivaarana m
நிறம்	niram	nira m
நிறுத்தப்பட்ட	niruththappatta	niru ththa ppatta
நிறுத்தி	niruththi	niru ththi
நிறுவப்பட்டது	niruvappattadhu	niru va ppatta dhu
நிறுவனத்தின்	niruvanaththin	niru vana thth in
நிறுவனத்துக்கு	niruvanaththukku	niru vana thth ukku
நிறுவனம்	niruvanam	niru vanam
நிறைய	niraiya	nira iya
நினோவின்	ninoovin	ninoo vin
நினோவும்	ninoovum	ninoo vum
நீங்க	niinga	niin ga
நீங்கள்	niingal	niin gal
நீட்	niit	niit
நீதி	niidhi	niidhi
நீதிபதிகள்	niidhibadhihal	niidhi badhi hal
நீதிமன்ற	niidhimanra	niidhi manra
நீதிமன்றத்தில்	niidhimanraththil	niidhi manra thth il
நீதிமன்றத்தின்	niidhimanraththin	niidhi manra thth in
நீதிமன்றம்	niidhimanram	niidhi manra m
நீதியை	niidhiyai	niidhi yai
நீராகாரம்	niiraahaaram	niir aahaa ram
நீரில்	niiril	niir il
நீரை	niirai	niir ai
நீரைத்	niiraith	niir ai th
நீரோட்டம்	niiroottam	niir oott am
நீர்மட்டம்	niirmattam	niir matt am
நீர்வரத்து	niirvaraththu	niir vara ththu
நீல	niila	niila
நீலம்	niilam	niila m
நுட்ப	nutpa	nut pa
நூற்றுக்கணக்கான	nuutrukkanakkaana	nuutru kkanakk aana
நெஞ்சில்	nenjil	nen jil
நெடுஞ்சாலையில்	nedunjaalaiyil	nedun jaalai yil
நெரிசல்	nerisal	neri sal
நெருக்கத்தில்	nerukkaththil	neru kka ththil
நெருங்கிப்	nerungip	neru ngi p
நேர	neera	neer a
நேரடியாக	neeradiyaaha	neer adi yaaha
நேரத்தில்	neeraththil	neer athth il
நேரத்திற்கு	neeraththirku	neer athth irku
நேரம்	neeram	neer am
நேரில்	neeril	neer il
நேருக்கு	neerukku	neer ukku
நேர்	neer	neer
நேர்ந்த	neerndha	neer ndha
நேற்றிரவு	neetriravu	neetr iravu
நேற்று	neetru	neetr u
நேற்றுப்	neetrup	neetr u p
நேற்றைய	neetraiya	neetr ai ya
நோக்கிப்	nookkip	nookki p
நோயாளிகளை	nooyaalihalai	nooy aali hal ai
நோயாளிகள்	nooyaalihal	nooy aali hal
நோயினால்	nooyinaal	nooy in aal
நோய்	nooy	nooy
நோய்கள்	nooykal	nooy kal
நோய்க்	nooyk	nooy k
நோய்த்	nooyth	nooy th
நோய்ப்	nooyp	nooy p
பகல்	pahal	pahal
பகுதி	pahudhi	pahudhi
பகுதிகளின்	pahudhihalin	pahudhi hal in
பகுதிகளைத்	pahudhihalaith	pahudhi hal ai th
பகுதிகள்	pahudhihal	pahudhi hal
பகுதிக்கு	pahudhikku	pahudhi kku
பகுதியளவில்	pahudhiyalavil	pahudhi yala vil
பகுதியாக	pahudhiyaaha	pahudhi ya aha
பகுதியிலும்	pahudhiyilum	pahudhi yil um
பகுதியை	pahudhiyai	pahudhi yai
பக்கத்தில்	pakkaththil	pakka<thth> il
பங்கு	pangu	pangu
பசிபிக்கில்	pasibikkil	pasi bikk il
பசுபிக்	pasubik	pasu bi k
பச்சை	pachchai	pachch ai
பஞ்சம்	panjam	pan jam
படகு	padahu	padahu
படகுகள்	padahuhal	padahu hal
படத்தில்	padaththil	pada ththil
படிக்க	padikka	padi kka
படித்து	padiththu	padi ththu
படிந்து	padindhu	padi ndhu
படுகாயம்	paduhaayam	padu haay am
படேல்	padeel	pad eel
படையினரின்	padaiyinarin	padai yinar in
பட்சத்தில்	patchaththil	patcha thth il
பண	pana	pana
பணி	pani	pani
பணிகளில்	panihalil	pani hal il
பணிகளுக்காக	panihalukkaaha	pani hal ukka aha
பணிகளுக்கு	panihalukku	pani hal ukku
பணிகளை	panihalai	pani hal ai
பணிகளையும்	panihalaiyum	pani hal ai yum
பணிகள்	panihal	pani hal
பணிப்பாளர்	panippaalar	pani ppaal ar
பணியகம்	paniyaham	pani ya ham
பணியாளர்கள்	paniyaalarkal	pani yaa lar kal
பணியாற்றிய	paniyaatriya	pani yaa triya
பணியில்	paniyil	pani yil
பணியின்	paniyin	pani yin
பணியை	paniyai	pani yai
பண்டாரகம	pantaarahama	pantaa rahama
பதவி	padhavi	padha vi
பதற்றத்துடன்	padhatraththudan	padha tra thth udan
பதிவாகியுள்ளது	padhivaahiyulladhu	padhi vaahiyu lladhu
பதிவானதாகவும்	padhivaanadhaahavum	padhi vaana dha aha vum
பதிவின்	padhivin	padhi vin
பதிவு	padhivu	padhi vu
பத்து	paththu	paththu
பயங்கரவாதம்	payangaravaadham	paya ngara vaadham
பயணத்தை	payanaththai	paya na thth ai
பயணம்	payanam	paya nam
பயணிகள்	payanihal	paya ni hal
பயன்	payan	paya n
பயன்படுத்த	payanbaduththa	payan badu ththa
பயன்படுத்தப்படுகின்றன	payanbaduththappaduhinrana	payan badu ththa ppadu hinr ana
பயன்படுத்தி	payanbaduththi	payan badu ththi
பயன்படுத்திய	payanbaduththiya	payan badu ththi ya
பயிர்	payir	payir
பயிர்களையும்	payirkalaiyum	payir kal ai yum
பரபரப்பு	parabarappu	para bara ppu
பரவலைத்	paravalaith	para val ai th
பரவல்	paraval	para val
பரவியது	paraviyadhu	para vi yadhu
பரவிவிடும்	paravividum	para vi vidum
பரவும்	paravum	para vum
பராமரிக்க	paraamarikka	paraa mari kka
பரிசோதனை	parisoodhanai	pari soodhanai
பரிதவிக்கும்	paridhavikkum	pari dhavi kkum
பருவ	paruva	paruva
பருவக்காற்றை	paruvakkaatrai	paruva kkaat rai
பருவமழை	paruvamazai	paruva mazai
பருவம்	paruvam	paruva m
பலசேனா	palaseenaa	pala see naa
பலத்த	palaththa	pala ththa
பலர்	palar	pala r
பலா	palaa	palaa
பலி	pali	pali
பலியாகியுள்ளனர்	paliyaahiyullanar	pali yaahi yulla nar
பலியாயினர்	paliyaayinar	pali yaayi nar
பல்கலைக்	palkalaik	pal kal ai k
பல்வேறு	palveeru	pal veeru
பழமை	pazamai	paza mai
பழைய	pazaiya	paza iya
பள்ளம்	pallam	pall am
பள்ளி	palli	palli
பள்ளிகளில்	pallihalil	palli hal il
பள்ளிக்கு	pallikku	palli kku
பள்ளியில்	palliyil	palli yil
பள்ளியின்	palliyin	palli yin
பறக்கிறது	parakkiradhu	para kkir adhu
பற்றி	patri	patri
பற்றிய	patriya	patri ya
பனிச்சரிவில்	panichcharivil	pani chchari vil
பனிச்சரிவு	panichcharivu	pani chchari vu
பனிப்புயல்	panippuyal	pani ppuyal
பன்முகப்	panmuhap	pan muha p
பன்றி	panri	panri
பன்றிக்	panrik	panri k
பன்றிக்காய்ச்சல்	panrikkaaychchal	panri kkaay chchal
பாகிஸ்தானியர்கள்	paahisthaaniyarkal	paa histhaani yar kal
பாகிஸ்தானில்	paahisthaanil	paa histhaan il
பாடசாலை	paadasaalai	paada saalai
பாடசாலைகள்	paadasaalaihal	paada saalai hal
பாடம்	paadam	paada m
பாதாள	paadhaala	paadhaa la
பாதி	paadhi	paadhi
பாதிக்கப்பட்ட	paadhikkappatta	paadhi kka ppatta
பாதிக்கப்பட்டவர்களுக்கு	paadhikkappattavarkalukku	paadhi kka ppatta var kal ukku
பாதிக்கப்பட்டவர்களை	paadhikkappattavarkalai	paadhi kka ppatta var kal ai
பாதிக்கப்பட்டன	paadhikkappattana	paadhi kka ppatt ana
பாதிக்கப்பட்டு	paadhikkappattu	paadhi kka ppattu
பாதிக்கப்பட்டுள்ள	paadhikkappattulla	paadhi kka ppatt ulla
பாதிக்கப்பட்டுள்ளதாக	paadhikkappattulladhaaha	paadhi kka ppatt ulla dhaa ha
பாதிக்கப்பட்டுள்ளது	paadhikkappattulladhu	paadhi kka ppatt ulla dhu
பாதிக்கப்பட்டுள்ளன	paadhikkappattullana	paadhi kka ppatt ulla na
பாதிக்கப்பட்டுள்ளனர்	paadhikkappattullanar	paadhi kka ppatt ulla nar
பாதிக்கிறது	paadhikkiradhu	paadhi kki radhu
பாதித்த	paadhiththa	paadhi ththa
பாதித்துள்ளது	paadhiththulladhu	paadhi thth ulladhu
பாதிப்பினை	paadhippinai	paadhi ppi nai
பாதிப்புகளை	paadhippuhalai	paadhi ppu hal ai
பாதிப்புக்குள்ளான	paadhippukkullaana	paadhi ppu kkulla ana
பாதிப்பும்	paadhippum	paadhi ppum
பாதிப்பை	paadhippai	paadhi ppai
பாதுகாக்க	paadhuhaakka	paadhu haakka
பாதுகாக்கப்பட்டுள்ளது	paadhuhaakkappattulladhu	paadhu haakka ppatt ulladhu
பாதுகாப்பாக	paadhuhaappaaha	paadhu haa ppaa ha
பாதுகாப்பு	paadhuhaappu	paadhu haa ppu
பாய்கிறது	paaykiradhu	paay kira dhu
பாருங்கள்	paarungal	paar ungal
பார்த்து	paarththu	paar ththu
பார்வை	paarvai	paar vai
பார்வையிட்டார்	paarvaiyittaar	paar vai yitt aar
பார்வையிட்டு	paarvaiyittu	paar vai yittu
பாலியல்	paaliyal	paali yal
பாலைவனத்தைக்	paalaivanaththaik	paalai vana thth ai k
பால்	paal	paal
பிடிக்கும்	pidikkum	pidi kkum
பிரகடனம்	pirahadanam	pira hada nam
பிரச்சாரம்	pirachchaaram	pira chchaa ram
பிரச்சினை	pirachchinai	pira chchi nai
பிரச்சினைகளில்	pirachchinaihalil	pira chchi nai hal il
பிரச்சினைக்கு	pirachchinaikku	pira chchi nai kku
பிரச்னை	pirachnai	pira ch nai
பிரதமர்	piradhamar	pira dha mar
பிரதான	piradhaana	pira dhaa na
பிரதிபா	piradhibaa	pira dhi baa
பிரதிப்	piradhip	pira dhi p
பிரதேச	piradheesa	pira dheesa
பிரதேசங்களிலுள்ள	piradheesangalilulla	pira dheesa<n> gal il ulla
பிரதேசங்களில்	piradheesangalil	pira dheesa<n> gal il
பிரதேசங்களைச்	piradheesangalaich	pira dheesa<n> gal ai ch
பிரதேசங்கள்	piradheesangal	pira dheesa<n> gal
பிரதேசத்தில்	piradheesaththil	pira dheesa thth il
பிரதேசத்தின்	piradheesaththin	pira dheesa thth in
பிரதேசம்	piradheesam	pira dheesa m
பிரவேசித்து	piraveesiththu	pira veesi ththu
பிரிந்து	pirindhu	piri ndhu
பிரிவினர்	pirivinar	piri vinar
பிரிவின்	pirivin	piri vin
பிரிவு	pirivu	piri vu
பிரிவும்	pirivum	piri vum
பிறகு	pirahu	pira hu
பிறகே	pirahee	pira hee
பிறை	pirai	pirai
பிறைக்	piraik	pirai k
பிற்பகல்	pirpahal	pir pahal
பின்	pin	pin
பின்னணியில்	pinnaniyil	pin nan iyil
பின்னரும்	pinnarum	pinn arum
பின்னர்	pinnar	pinn ar
பீதி	piidhi	piidhi
பீதியில்	piidhiyil	piidhi yil
புதன்	pudhan	pudhan
புதன்கிழமை	pudhangizamai	pudhan giza mai
புதிதாக	pudhidhaaha	pudhi dhaaha
புதிய	pudhiya	pudhi ya
புதுசு	pudhusu	pudhu su
புதைந்து	pudhaindhu	pudhai ndhu
புதையுண்டு	pudhaiyuntu	pudhai yuntu
புயலாக	puyalaaha	puyal aaha
புயலில்	puyalil	puyal il
புயலினால்	puyalinaal	puyal in aal
புயலின்	puyalin	puyal in
புயலுக்கு	puyalukku	puyal ukku
புயல்	puyal	puyal
புவியியல்	puviyiyal	puvi yiyal
புள்ளி	pulli	pulli
புறம்	puram	puram
பூகம்பம்	puuhambam	puu ham bam
பூமியின்	puumiyin	puu mi yin
பெண்	pen	pen
பெண்களை	penkalai	pen kal ai
பெண்கள்	penkal	pen kal
பெண்ணை	pennai	pen nai
பெயரிடப்பட்டது	peyaridappattadhu	peyar ida ppatta dhu
பெயர்	peyar	peyar
பெய்த	peytha	pey tha
பெய்துவரும்	peythuvarum	pey thu varum
பெய்துள்ளது	peythulladhu	pey thull adhu
பெய்யத்	peyyath	peyya th
பெய்யும்	peyyum	peyyu m
பெரிதும்	peridhum	peridhu m
பெரிய	periya	periya
பெரு	peru	peru
பெருக்கு	perukku	peru kku
பெருங்கடலில்	perungadalil	peru<n> gadal il
பெருங்கடலின்	perungadalin	peru<n> gadal in
பெருந்தோட்டத்	perundhoottath	perun dhoott ath
பெரும்	perum	perum
பெரும்பாலான	perumbaalaana	perum baala ana
பெற	pera	pera
பெறுகிறீர்கள்	peruhiriirkal	peru hiriir kal
பெறும்	perum	peru m
பெற்ற	petra	petra
பெற்றுக்	petruk	petru k
பேசி	peesi	peesi
பேசிய	peesiya	peesi ya
பேசுகையில்	peesuhaiyil	peesu hai yil
பேச்சாளர்	peechchaalar	peechch aalar
பேச்சுவார்த்தை	peechchuvaarththai	peechchu vaar ththai
பேச்சுவார்த்தையில்	peechchuvaarththaiyil	peechchu vaar ththai yil
பேரலை	peeralai	peer alai
பேரின்	peerin	peer in
பேருந்து	peerundhu	peer undhu
பேரும்	peerum	peer um
பேரை	peerai	peer ai
பேர்	peer	peer
பையன்	paiyan	pai yan
பொதுமக்களையும்	podhumakkalaiyum	podhu makkal ai yum
பொதுமக்கள்	podhumakkal	podhu makkal
பொய்யான	poyyaana	poyy aana
பொருட்	porut	porut
பொருட்களை	porutkalai	porut kal ai
பொருட்கள்	porutkal	porut kal
பொருட்டு	poruttu	porutt u
பொருளாதார	porulaadhaara	porul aadhaara
பொருளாதாரப்	porulaadhaarap	porul aadhaara p
பொருளாதாரம்	porulaadhaaram	porul aadhaara m
பொருள்	porul	porul
பொலிஸாரும்	polisaarum	poli saa rum
பொழுது	pozudhu	poz udhu
பொள்ளாச்சி	pollaachchi	poll aachchi
பொறுப்பதிகாரி	poruppadhihaari	porupp adhi haari
பொறுப்பு	poruppu	porupp u
பொறுப்பை	poruppai	porupp ai
போக	pooha	poo ha
போக்குவரத்து	pookkuvaraththu	poo kku vara ththu
போக்கை	pookkai	poo kkai
போட்டது	poottadhu	poott adhu
போட்டோக்களை	poottookkalai	poott oo kka lai
போதும்	poodhum	poo dhum
போதைப்	poodhaip	poo dhai p
போயுள்ளார்	pooyullaar	pooy ullaar
போய்	pooy	pooy
போய்விட்டது	pooyvittadhu	pooy vitt adhu
போராடி	pooraadi	poor aadi
போராட்டத்துக்கு	pooraattaththukku	poor aatta thth ukku
போர்	poor	poor
போர்க்கால	poorkkaala	poor kkaala
போல	poola	poola
போலவோ	poolavoo	poola voo
போலீஸார்	pooliisaar	pooliis aar
போலீஸ்	pooliis	pooliis
போனது	poonadhu	poona dhu
போனாள்	poonaal	poon aal
போன்ற	poonra	poon ra
போன்றவற்றில்	poonravatril	poon ra vatr il
போன்றவையும்	poonravaiyum	poon ra vai yum
மக்களுக்காக	makkalukkaaha	makkal ukka aha
மக்களுக்கான	makkalukkaana	makkal ukka ana
மக்களுக்கு	makkalukku	makkal ukku
மக்களும்	makkalum	makkal um
மக்களை	makkalai	makkal ai
மக்களைப்	makkalaip	makkal ai p
மடங்கு	madangu	madangu
மட்ட	matta	matta
மட்டத்தில்	mattaththil	matta ththil
மட்டும்	mattum	matt um
மணி	mani	mani
மணிக்கு	manikku	mani kku
மணிக்கும்	manikkum	mani kkum
மணிநேரம்	manineeram	mani neeram
மண்	man	man
மண்சரிவால்	mancharivaal	man chariv aal
மண்சரிவினால்	mancharivinaal	man charivi naal
மண்சரிவு	mancharivu	man charivu
மண்டலத்தில்	mantalaththil	man tala ththil
மண்டலமாக	mantalamaaha	man tala maaha
மண்டை	mantai	man tai
மண்ணில்	mannil	mann il
மத	madha	madha
மதிப்பிலான	madhippilaana	madhi ppil aana
மதிப்பீடு	madhippiidu	madhi pp iidu
மதிப்பீட்டில்	madhippiittil	madhi ppiitt il
மதியம்	madhiyam	madhi yam
மதுவிலக்கை	madhuvilakkai	madhu vila kkai
மதுவுக்கு	madhuvukku	madhu vu kku
மத்திய	maththiya	maththi ya
மத்தியில்	maththiyil	maththi yil
மந்தரில்	mandharil	mandhar il
மரங்கள்	marangal	mara<n> gal
மரண	marana	marana
மரணங்கள்	maranangal	marana<n> gal
மரணம்	maranam	marana m
மருத்துவ	maruththuva	maruththuva
மருத்துவமனை	maruththuvamanai	maruththuva manai
மருத்துவமனைக்கு	maruththuvamanaikku	maruththuva manai kku
மருத்துவமனையில்	maruththuvamanaiyil	maruththuva manai yil
மருத்துவர்	maruththuvar	maruththu var
மருத்துவர்கள்	maruththuvarkal	maruththu var kal
மருந்துப்	marundhup	marundh u p
மருந்தை	marundhai	marundh ai
மலை	malai	malai
மலைகளின்	malaihalin	malai hal in
மலைக்காற்றில்	malaikkaatril	malai kkaatr il
மலையக	malaiyaha	malai yaha
மலையகத்தில்	malaiyahaththil	malai yaha thth il
மலையகப்	malaiyahap	malai yaha p
மலையின்	malaiyin	malai yin
மலையே	malaiyee	malai yee
மழை	mazai	mazai
மழைக்கு	mazaikku	mazai kku
மழையால்	mazaiyaal	mazai yaal
மழையிலும்	mazaiyilum	mazai yil um
மழையினால்	mazaiyinaal	mazai yi naal
மழையின்	mazaiyin	mazai yin
மழையுடன்	mazaiyudan	mazai yudan
மழையை	mazaiyai	mazai yai
மற்ற	matra	matra
மற்றுமொரு	matrumoru	matrum oru
மற்றும்	matrum	matrum
மனிதன்	manidhan	mani dhan
மன்மோகன்சிங்	manmoohanjin	man moo han ji<n>
மஸ்கட்	maskat	maskat
மாகாணங்களில்	maahaanangalil	maahaana<n> gal il
மாகாணங்களின்	maahaanangalin	maahaana<n> gal in
மாகாணத்தில்	maahaanaththil	maahaana ththil
மாகாணத்தின்	maahaanaththin	maahaana ththin
மாணவர்களின்	maanavarkalin	maanavar kal in
மாணவர்கள்	maanavarkal	maanavar kal
மாத	maadha	maa dha
மாதங்களில்	maadhangalil	maa dha<n> gal il
மாதங்களுக்கு	maadhangalukku	maa dha<n> gal ukku
மாதம்	maadham	maa dham
மாதிரி	maadhiri	maa dhiri
மாத்தறை	maaththarai	maa thth arai
மாத்திரம்	maaththiram	maa ththi ram
மாத்திரை	maaththirai	maa ththi rai
மாநில	maanila	maa nila
மாநிலங்களில்	maanilangalil	maa nila<n> gal il
மாநிலத்தின்	maanilaththin	maa nila ththin
மாநிலம்	maanilam	maa nilam
மாயம்	maayam	maa yam
மாலை	maalai	maa lai
மாலைதீவுகளின்	maalaidhiivuhalin	maa lai dhiivu hal in
மாவட்ட	maavatta	maa vatta
மாவட்டங்களிலும்	maavattangalilum	maa vatta<n> gal il um
மாவட்டங்களிலுள்ள	maavattangalilulla	maa vatta<n> gal il ulla
மாவட்டங்களிலேயே	maavattangalileeyee	maa vatta<n> gal il eeyee
மாவட்டங்களில்	maavattangalil	maa vatta<n> gal il
மாவட்டங்கள்	maavattangal	maa vatta<n> gal
மாவட்டத்தில்	maavattaththil	maa vatta ththil
மாவட்டத்தின்	maavattaththin	maa vatta ththin
மாவட்டம்	maavattam	maa vattam
மாறாக	maaraaha	maa raaha
மாறியதால்	maariyadhaal	maari ya dhaal
மாறியது	maariyadhu	maari ya dhu
மாறுபாட்டை	maarubaattai	maaru baatt ai
மாற்றப்பட்டு	maatrappattu	maatra ppattu
மாற்றப்பட்டுள்ளது	maatrappattulladhu	maatra ppattu lladhu
மாற்றமே	maatramee	maatra mee
மாற்றம்	maatram	maatra m
மாற்று	maatru	maatru
மிக	miha	miha
மிகப்	mihap	miha p
மிகப்பெரிய	mihapperiya	miha ppe riya
மிகப்பெரும்	mihapperum	miha ppe rum
மிகவும்	mihavum	miha vum
மிகுந்த	mihundha	mihu ndha
மிக்க	mikka	mikka
மிதமான	midhamaana	midha maana
மியான்மர்	miyaanmar	mi yaa nmar
மிரட்டும்	mirattum	mira ttum
மின்சார	minjaara	min jaara
மின்சாரம்	minjaaram	min jaaram
மீட்க	miitka	miitka
மீட்கப்பட்டது	miitkappattadhu	miitka ppatt adhu
மீட்கப்பட்டனர்	miitkappattanar	miitka ppatta nar
மீட்கப்பட்டு	miitkappattu	miitka ppattu
மீட்கப்பட்டுள்ளனர்	miitkappattullanar	miitka ppatt ulla nar
மீட்டர்	miittar	miitta r
மீட்டனர்	miittanar	miitt an ar
மீட்டு	miittu	miittu
மீட்பு	miitpu	miitpu
மீட்புதவி	miitpudhavi	miitpu dhavi
மீட்புப்	miitpup	miitpu p
மீட்புப்படையினர்	miitpuppadaiyinar	miitpu ppadai yinar
மீட்புப்பணி	miitpuppani	miitpu ppani
மீண்டும்	miintum	miin tum
மீதான	miidhaana	miidh aana
மீது	miidhu	miidh u
மீற்றர்	miitrar	miit rar
மீனவர்கள்	miinavarkal	miina var kal
முகமூடி	muhamuudi	muha muudi
முகம்	muham	muha m 
முகாமைத்துவ	muhaamaiththuva	muhaa mai ththu va
முகாம்களில்	muhaamgalil	muhaa m gal il
முக்கிய	mukkiya	mukkiya
முக்கியத்துவம்	mukkiyaththuvam	mukkiya ththuvam
முச்சக்கரவண்டி	muchchakkaravanti	muchcha kkara vanti
முடிந்த	mudindha	mudindha
முடியாததால்	mudiyaadhadhaal	mudiyaadh adhaal
முடியாது	mudiyaadhu	mudiyaadh u
முதலமைச்சர்	mudhalamaichchar	mudhal amaichch ar
முதலிய	mudhaliya	mudhal iya
முதலில்	mudhalil	mudhal il
முதலே	mudhalee	mudhal ee
முதல்	mudhal	mudhal
முப்படையினரும்	muppadaiyinarum	muppa dai yinar um
மும்பைக்கு	mumbaikku	mumbai kku
முயற்சி	muyarchi	muyarchi
முயற்சித்து	muyarchiththu	muyarchi ththu
முயற்சியில்	muyarchiyil	muyarchi yil
முல்லைத்தீவு	mullaiththiivu	mullai ththii vu
முல்லைப்பெரியாறு	mullaipperiyaaru	mullai pperiy aaru
முழங்கால்	muzangaal	muza<n> gaal
முழு	muzu	muzu
முழுவதும்	muzuvadhum	muzu vadhum
முழுவீச்சில்	muzuviichchil	muzu viichch il
முறை	murai	murai
முறைகள்	muraihal	murai hal
முறைப்பாடு	muraippaadu	murai ppaadu
முறையற்ற	muraiyatra	murai yatra
முறையாக	muraiyaaha	murai yaaha
முறையான	muraiyaana	murai yaana
முற்றாக	mutraaha	mutr aaha
முற்றிலும்	mutrilum	mutr ilum
முன்	mun	mun
முன்கூட்டியே	munguuttiyee	mun guutti yee
முன்தினம்	mundhinam	mun dhinam
முன்பே	munbee	mun bee
முன்னணியில்	munnaniyil	munn ani yil
முன்னதாக	munnadhaaha	munn adha aha
முன்னர்	munnar	munn ar
முன்னுரிமை	munnurimai	munn urimai
முன்னெச்சரிக்கையை	munnechcharikkaiyai	munn ech chari kkai yai
முன்னேற்றப்	munneetrap	munn eetra p
முன்னேற்றம்	munneetram	munn eet ram
மூட	muuda	muuda
மூடப்பட்டது	muudappattadhu	muuda ppatt adhu
மூடப்பட்டன	muudappattana	muuda ppatt ana
மூத்த	muuththa	muu ththa
மூலமாக	muulamaaha	muu lam aaha
மூலம்	muulam	muul am
மூழ்கி	muuzhki	muuzhki
மூழ்கியுள்ளன	muuzhkiyullana	muuzhki yull ana
மூழ்கிவிட்டன	muuzhkivittana	muuzhki vitt ana
மூன்றாம்	muunraam	muun raam
மூன்று	muunru	muun ru
மெக்கா	mekkaa	mekkaa
மேலாக	meelaaha	meel aaha
மேலாண்மை	meelaanmai	meel aan mai
மேலும்	meelum	meel um
மேற்கொண்ட	meerkonta	meer konta
மேற்கொண்டது	meerkontadhu	meer kont adhu
மேற்கொண்டு	meerkontu	meer kontu
மேற்கொள்ள	meerkolla	meer kolla
மேற்கொள்ளப்பட்டன	meerkollappattana	meer kolla ppatt ana
மைய	maiya	maiya
மையம்	maiyam	maiya m
மொத்தமாக	moththamaaha	moththa maaha
மோசமாக	moosamaaha	moosa maaha
மோசமான	moosamaana	moosa maana
மோடி	moodi	moodi
மோடிக்கு	moodikku	moodi kku
மோதல்	moodhal	moodh al
மோதி	moodhi	moodh i
யாரும்	yaarum	yaar um
யார்	yaar	yaar
யானைகளை	yaanaihalai	yaanai hal ai
யானைகள்	yaanaihal	yaanai hal
யூனியனும்	yuuniyanum	yuuniyan um
ரத்து	raththu	raththu
ரயில்	rayil	rayil
ராணுவ	raanuva	raanuva
ராணுவத்தினர்	raanuvaththinar	raanuva ththi nar
ராணுவமும்	raanuvamum	raanuva mum
ரூபாய்	ruubaay	ruu baay
ரோட்டைக்	roottaik	roottai k
ரோம்	room	room
லட்சத்து	latchaththu	latcha ththu
லட்சத்துக்கும்	latchaththukkum	latcha ththu kkum
லட்சம்	latcham	latcha m
லயன்களின்	layangalin	layan gal in
வகுப்பறைகளை	vahupparaihalai	vahupp arai hal ai
வகுப்பறையில்	vahupparaiyil	vahupp arai yil
வகை	vahai	vahai
வகையான	vahaiyaana	vahai yaa na
வகையில்	vahaiyil	vahai yil
வங்க	vanga	vanga
வங்காள	vangaala	vangaa la
வங்காளதேசத்தில்	vangaaladheesaththil	vangaa la dheesa thth il
வங்கிகளில்	vangihalil	vangi hal il
வங்கிக்	vangik	vangi k
வசதிகள்	vasadhihal	vasa dhi hal
வசந்தம்	vasandham	vasa ndham
வசிக்கும்	vasikkum	vasi kkum
வட	vada	vada
வடகிழக்குப்	vadahizakkup	vada hizakku p
வடமேற்கு	vadameerku	vada meerku
வடிவ	vadiva	vadiva
வட்டத்தில்	vattaththil	vatta ththil
வட்டாரத்தில்	vattaaraththil	vatta ara thth il
வந்த	vandha	vand ha
வந்தடைந்த	vandhadaindha	vand ha da indha
வந்தது	vandhadhu	vand ha dhu
வந்தன	vandhana	vand ha na
வந்தாலென்ன	vandhaalenna	vand haa lenna
வந்து	vandhu	vand hu
வந்துள்ளன	vandhullana	vand hu llana
வயதிற்கு	vayadhirku	vayadh irku
வர	vara	vara
வரலாறு	varalaaru	vara laaru
வரவேண்டும்	varaveentum	vara veen tum
வரித்துறையில்	variththuraiyil	vari ththu rai yil
வருகிறது	varuhiradhu	varu hira dhu
வருகின்றனர்	varuhinranar	varu hinra nar
வருகை	varuhai	varu hai
வருடங்கள்	varudangal	varu da<n> gal
வருடத்திற்கு	varudaththirku	varu da ththi rku
வருடம்	varudam	varu da m
வருதாம்	varudhaam	varu dhaa m
வருவதாக	varuvadhaaha	varu va dhaaha
வருவதால்	varuvadhaal	varu va dhaal
வருவது	varuvadhu	varu va dhu
வருவார்கள்	varuvaarkal	varu vaar kal
வரை	varai	varai
வரைக்கும்	varaikkum	varai kkum
வரையான	varaiyaana	varai yaana
வர்ணம்	varnam	var nam
வலி	vali	vali
வலிமையை	valimaiyai	vali mai yai
வலியுறுத்தி	valiyuruththi	vali yuru ththi
வலுப்படுத்துவது	valuppaduththuvadhu	valu ppadu ththu vadhu
வலுப்பெற்று	valuppetru	valu ppetru
வலுவடைந்து	valuvadaindhu	valu vada indhu
வலுவிழந்து	valuvizandhu	valu viza ndhu
வவுனியாவில்	vavuniyaavil	vavuni yaav il
வழக்கமாக	vazakkamaaha	vaza kkam aaha
வழக்கமான	vazakkamaana	vaza kkam aana
வழக்கறிஞர்	vazakkarinyar	vaza kkar iny ar
வழக்கு	vazakku	vaza kku
வழக்கை	vazakkai	vaza kkai
வழங்க	vazanga	vaza nga
வழங்கப்படும்	vazangappadum	vaza nga ppad um
வழங்கப்பட்டது	vazangappattadhu	vaza nga ppatt adhu
வழங்கவும்	vazangavum	vaza nga vum
வழங்குமாறு	vazangumaaru	vaza ngu maaru
வழங்குவதற்கு	vazanguvadharku	vaza ngu vadha rku
வழங்குவதைத்	vazanguvadhaith	vaza ngu vadhai th
வழியாக	vaziyaaha	vazi yaaha
வழியில்	vaziyil	vazi yil
வளர்ச்சி	valarchchi	valar chchi
வளர்ச்சிக்கும்	valarchchikkum	valar chchi kkum
வளர்ச்சியில்	valarchchiyil	valar chchi yil
வளைந்து	valaindhu	valai ndhu
வறட்சி	varatchi	varat chi
வறட்சியை	varatchiyai	varat chi yai
வறண்ட	varanta	varan ta
வனச்சரகர்	vanachcharahar	vana chcha rah ar
வனத்துறையினர்	vanaththuraiyinar	vana thth urai yin ar
வனப்பகுதிக்கு	vanappahudhikku	vana ppah udhi kku
வனப்பகுதியில்	vanappahudhiyil	vana ppah udhi yil
வன்னி	vanni	vanni
வாகன	vaahana	vaa hana
வாகனங்கள்	vaahanangal	vaa hana<n> gal
வாகனத்தில்	vaahanaththil	vaa hana ththil
வாகனப்	vaahanap	vaa hana p
வாகனம்	vaahanam	vaa hana m
வாங்கி	vaangi	vaa ngi
வாசி	vaasi	vaa si
வாசிக்க	vaasikka	vaa si kka
வாந்தி	vaandhi	vaan dhi
வாய்ப்பில்லை	vaayppillai	vaaypp illai
வாய்ப்பு	vaayppu	vaaypp u
வாய்ப்பை	vaayppai	vaaypp ai
வாரங்களுக்கு	vaarangalukku	vaara<n> gal ukku
வாரம்	vaaram	vaaram
வார்டுகளைச்	vaartuhalaich	vaartu hal ai ch
வார்த்தையின்	vaarththaiyin	vaarthth ai yin
வால்	vaal	vaal
வாழும்	vaazum	vaaz um
வாழ்க்கை	vaazhkkai	vaazh kkai
வாழ்த்து	vaazhththu	vaazh ththu
வாழ்வும்	vaazhvum	vaazh vum
வானிலை	vaanilai	vaani lai
வான்	vaan	vaan
வான்வழி	vaanvazi	vaan vazi
விசாரணை	visaaranai	visaa ran ai
விஞ்ஞானிகள்	vinynyaanihal	vinyn yaani hal
விட	vida	vida
விடியாத	vidiyaadha	vidi ya adha
விடுக்கப்படவில்லை	vidukkappadavillai	vidu kka ppada vill ai
விடுக்கப்பட்ட	vidukkappatta	vidu kka ppatta
விடுக்கப்பட்டன	vidukkappattana	vidu kka ppatta na
விடுக்கப்பட்டுள்ளது	vidukkappattulladhu	vidu kka ppatt ull adhu
விடுங்கள்	vidungal	vidun gal
விடுதியில்	vidudhiyil	vidu dhi yil
விடுத்தது	viduththadhu	vidu thth adhu
விடுத்துள்ள	viduththulla	vidu thth ulla
விடுத்துள்ளனர்	viduththullanar	vidu thth ulla nar
விட்டன	vittana	vittana
விதமாக	vidhamaaha	vidha maaha
வித்தியாசம்	viththiyaasam	viththi yaa sam
விபத்தில்	vibaththil	viba thth il
விபத்து	vibaththu	viba thth u
விபத்துக்கு	vibaththukku	viba ththu kku
விபத்துக்குள்ளான	vibaththukkullaana	viba ththu kkull aana
விபரங்களை	vibarangalai	viba ra<n> gal ai
விமானத்தில்	vimaanaththil	vimaana thth il
விமானப்படை	vimaanappadai	vimaana ppad ai
விமானம்	vimaanam	vimaana m
வியட்நாமை	viyatnaamai	viyat naam ai
வியாழன்	viyaazan	viyaa zan
விரட்ட	viratta	viratta
விரட்டியடித்தனர்	virattiyadiththanar	viratti yadi ththa nar
விருந்தது	virundhadhu	virun dha dhu
விரைந்து	viraindhu	virai ndhu
விரைவில்	viraivil	virai vil
விரைவு	viraivu	virai vu
விலக	vilaha	vila ha
விலக்கிக்	vilakkik	vila kki k
விலை	vilai	vilai
விலையை	vilaiyai	vilai yai
விவகாரத்தில்	vivahaaraththil	viva haara ththil
விவசாய	vivasaaya	viva saaya
விவசாயத்தின்	vivasaayaththin	viva saaya ththin
விவசாயம்	vivasaayam	viva saaya m
விவசாயி	vivasaayi	viva saayi
விவசாயிகளின்	vivasaayihalin	viva saayi hal in
விவசாயிகளுக்கு	vivasaayihalukku	viva saayi hal ukku
விவசாயிகளுக்கும்	vivasaayihalukkum	viva saayi hal ukku m
விவசாயிகள்	vivasaayihal	viva saayi hal
விவரங்களுக்கு	vivarangalukku	viva ra<n> gal ukku
விழிப்புடன்	vizippudan	vizipp udan
விழிப்புணர்வு	vizippunarvu	vizipp unar vu
விழுந்த	vizundha	vizu ndha
விழுந்ததால்	vizundhadhaal	vizu ndhadh aal
விழுந்தது	vizundhadhu	vizu ndha dhu
விழுந்தன	vizundhana	vizu ndhana
விழுந்து	vizundhu	vizu ndhu
விழுப்புரம்	vizuppuram	vizu ppur am
விளக்க	vilakka	vila kka
விளக்கம்	vilakkam	vila kka m
விளைவாக	vilaivaaha	vilai vaaha
விளைவுகள்	vilaivuhal	vilai vu hal
விற்பனை	virpanai	vir pan ai
விஜயம்	vijayam	vijay am
விஷயம்	vishayam	visha yam
வீசப்பட்டது	viisappattadhu	viisa ppatta dhu
வீசியதால்	viisiyadhaal	viisi yadhaal
வீசியது	viisiyadhu	viisi yadhu
வீசும்	viisum	viisu m
வீச்சுப்	viichchup	viichchu p
வீடு	viidu	viidu
வீடுகளின்	viiduhalin	viidu hal in
வீடுகளுக்குச்	viiduhalukkuch	viidu hal ukku ch
வீடுகளும்	viiduhalum	viidu hal um
வீடுகளை	viiduhalai	viidu ha lai
வீடுகளையும்	viiduhalaiyum	viidu hal ai yum
வீடுகள்	viiduhal	viidu hal
வீடும்	viidum	viidu m
வீட்டில்	viittil	viitt il
வீதி	viidhi	viidhi
வீதிகளில்	viidhihalil	viidhi hal il
வீதிகள்	viidhihal	viidhi hal
வீரர்	viirar	viir ar
வீழ்ச்சி	viizhchchi	viizh chchi
வீழ்த்திய	viizhththiya	viizh ththi ya
வெடி	vedi	vedi
வெடித்தது	vediththadhu	vedi ththa dhu
வெடிப்பு	vedippu	vedi ppu
வெப்ப	veppa	veppa
வெப்பத்தின்	veppaththin	veppa ththin
வெப்பநிலை	veppanilai	veppa nilai
வெப்பம்	veppam	veppa m
வெயிலின்	veyilin	veyil in
வெயில்	veyil	veyil
வெளிநாட்டு	velinaattu	veli naattu
வெளியாகியுள்ளது	veliyaahiyulladhu	veli yaahi yull adhu
வெளியான	veliyaana	veli yaana
வெளியுறவுத்துறை	veliyuravuththurai	veli yuravu ththur ai
வெளியே	veliyee	veli yee
வெளியேற	veliyeera	veli yeera
வெளியேறிய	veliyeeriya	veli yeeri ya
வெளியேறியது	veliyeeriyadhu	veli yeeri yadhu
வெளியேறுமாறு	veliyeerumaaru	veli yeeru maaru
வெளியேற்றம்	veliyeetram	veli yeetr am
வெள்ள	vella	vella
வெள்ளங்கள்	vellangal	vella<n> gal
வெள்ளத்	vellath	vella th
வெள்ளத்தால்	vellaththaal	vella thth aal
வெள்ளத்தில்	vellaththil	vella thth il
வெள்ளத்தினால்	vellaththinaal	vella thth in aal
வெள்ளத்தின்	vellaththin	vella thth in
வெள்ளநீரில்	vellaniiril	vella niir il
வெள்ளப்	vellap	vella p
வெள்ளப்பாதிப்படைந்தவர்களுக்கு	vellappaadhippadaindhavarkalukku	vella ppaadhi ppadai ndha var kal ukku
வெள்ளப்பெருக்கு	vellapperukku	vella pper ukku
வெள்ளம்	vellam	vella m
வெள்ளிக்கிழமை	vellikkizamai	velli kkiza mai
வேகத்தில்	veehaththil	veeha thth il
வேகமாக	veehamaaha	veeha m aaha
வேகம்	veeham	veeha m
வேண்டிக்	veentik	veenti k
வேண்டிய	veentiya	veenti ya
வேண்டுகோள்	veentuhool	veentu hool
வேண்டுமென்று	veentumenru	veentu menru
வேண்டும்	veentum	veentu m
வேதனைக்குரியது	veedhanaikkuriyadhu	vee dhanai kkuriya dhu
வேரோடு	veeroodu	vee roodu
வேலை	veelai	vee lai
வேளை	veelai	vee lai
வேற	veera	vee ra
வேறு	veeru	vee ru
வைக்கப்பட்டிருந்த	vaikkappattirundha	vaikka ppatt irundha
வைக்கப்பட்டு	vaikkappattu	vaikka ppattu
வைக்கப்பட்டுள்ளன	vaikkappattullana	vaikka ppatt ullana
வைக்கப்பட்டுள்ளனர்	vaikkappattullanar	vaikka ppatt ullan ar
வைக்கிறது	vaikkiradhu	vaikk iradhu
வைக்கும்	vaikkum	vaikk um
வைத்தது	vaiththadhu	vai ththa dhu
வைத்தனர்	vaiththanar	vai ththa nar
வைத்து	vaiththu	vai ththu
வைத்துப்	vaiththup	vai ththu p
ஜப்பானில்	jappaanil	jappaan il
ஜனாதிபதி	janaadhibadhi	jana adhi badhi
ஸ்கேலில்	skeelil	skeel il
ஹெலிகாப்டர்கள்	helihaaptarkal	helihaaptar kal
