token	segmentation	root
ábrája	ábrá ja	ábra
ábrán	ábrá n	ábra
acél	acél	acél
adataival	adat a i val	adat 
adathalmazt	adat halmaz t	adat 
addigra	addig ra	addig
adott	ad ott	ad 
aeroszolizálta	aeroszol izált a	aeroszol 
aggodtam	aggod tam	aggod
aggódunk	aggód unk	aggód 
ágyas	ágy as	ágy
ahogy	a hogy	hogy
Ahol	A hol	hol
ahova	a hova	hova
Ajánlott	Ajánl ott	Ajánl
akác	akác	akác
akció	akció	akció
akibe	a ki be	ki
aktivizálódása	aktiv i zá ló dás a	aktiv 
aktuális	aktuális	aktuális
aktuálisan	aktuális an	aktuális
alábukás	alá bukás	buk
alábukását	alá bukás á t	buk
alakították	alakított ák	alakít
alakjuk	alak juk	alak
alapvetőbb	alap vető bb	alap
Alapvetően	Alap vető en	Alap 
alatt	alatt	alatt
Áldott	Áldott	Áld
áldozata	áld oz at a	áldoz 
áldozataikat	áld oz at a i kat	áldoz
áldozatainak	áld oz at a i nak	áldoz 
áldozat	áld oz at	áldoz
áldozatának	áld oz at á nak	áldoz
áldozatául	áld oz at á ul	áldoz
áldozatokról	áld oz at ok ról	áldoz
áldozatra	áld oz at ra	áldoz
áldozatul	áld oz at ul	áldoz
alföldi	alföld i	alföld
alkalmazása	alkalmaz ása	alkalmas
alkalmazható	alkalmaz hat ó	alkalmas
alkalmazták	alkalmaz ták	alkalmas
alkotmányba	alkotmány ba	alkot
Állam	Állam	Állam
Államok	Állam ok	Állam
Államokban	Állam ok ban	Állam
állapotokat	állapot ok at	állapot
álláspontra	áll ás pont ra	áll
allnak	all nak	all
állnak	áll nak	áll
állt	áll t	áll
álltok	áll t ok	áll
állunk	ál lunk	áll
általában	által á ban	által
által	által	által
Amatőr	Amatőr	Amatőr
amelyet	amely et	amely
amelynek	amely nek	amely
amennyire	amennyi re	amennyi
Amerikai	Amerika i	Amerika
amiért	a miért	miért
Amint	Amint	Ami
amitől	ami től	ami
amivel	a mivel	mivel
Anglia	Anglia	Anglia
Ankarai	Ankara i	Ankara
annal	annal	annal
annyira	annyir a	annyi
anyagok	anyag ok	anyag
ápoltak	ápol t ak	ápol 
áprilisi	április i	április
apró	apró	apró
arab	arab	arab
áradása	árad ás a	árad
áradás	árad ás	árad
Áram	Áram	Áram
áramlásainak	áram lás a i nak	áram
áramlás	áram lás	áram
arány	arány	arány
arányt	arány t	arány
árban	ár ban	ár
arcukra	arcuk ra	arc
árkádok	árkád ok	árkád
Árvíz	Ár víz	víz
asztal	asztal	asztal
átadni	át ad ni	ad
átadó	át ad ó	ad
áthaladt	át halad t	halad
átjárt	át jár t	jár
átkelőn	át kelő n	kel
átkeresztelték	át kereszt el ték	kereszt
átlagosan	át lag os an	átlag
átlagosnak	át lag os nak	átlag
átlagosnál	átlagos nál	átlag
atlantai	atlanta i	atlanta
atrocitás	atroci t ás	atrocitás
átsöpör	át söpör	söpör
átszelte	át szelt e	szel
átvillant	át villan t	villan
Augusztus	Augusztus	Augusztus
augusztusban	augusztus ban	augusztus
Ausztráliában	Ausztráliá ban	Ausztráliá
Autóba	Au tóba	Autó
avartűz	avar tűz	avar + tűz
azáltal	az által	által
azbeszt	azbeszt	azbeszt
azokat	az ok at	az 
Ázsia	Ázsia	Ázsia
Ázsiában	Ázsiá ban	Ázsiá
aztám	az tám	az tám
aztán	aztán	aztán
bacsik	bacsi k	bacsi
baja	baj a	baj
Bajor	Bajor	Bajor
bajuk	baj uk	baj
baloldal	bal oldal	oldal
Baloldali	Bal oldal i	oldal
bányakatasztrófáktól	bánya katasztrófá k tól	bánya
Bárányhimlő	Bárány himlő	Bárány
bar	bar	bar
barcsak	bar csak	bar 
bárhol	bár hol	bár 
bármi	bár mi	bár
bazársor	bazár sor	bazár
beavatkozás	be avatkoz ás	avatkozik
be	be	be
beborította	be borít ott a	borít 
Bécsben	Bécs ben	Bécs
befogadja	be fogad ja	fogad
befolyásolni	be foly ás ol ni	foly
begyűjteni	be gyűj ten i	gyűjt
behelyezése	be hely ez é se	hely
bejegyzés	be jegy zés	jegy
bejelentkezve	be jelent kez ve	jelent
bekövetkezte	be követ kez te	követ
belépő	be lép ő	lép 
belole	be lo le	belole
belőle	be lől e	belőle
belül	belül	belül
Benettonnal	Benetton nal	Benetton
benézett	be nézet t	nézet
benne	benne	benne
bent	bent	bent
beosztottja	be osztott ja	oszt
berakása	be rak ása	rak
berendezeseket	be rend ez es ek et	rend 
bergadali	bergadal i	bergadal
Berlinben	Berlin ben	Berlin
beszámolt	be számol t	számol
beszélgetett	beszél get ett	beszél
beszélgethessenek	beszél get hessen ek	beszél
beszélgetni	beszél get ni	beszél
beszélgetve	beszél get ve	beszél 
beszélt	beszél t	beszél
beszelve	beszel ve	beszel
beszoltam	be szolt am	szolt
betegeiket	beteg e i ket	beteg
betegséggel	beteg ség gel	beteg 
betegségnek	beteg ség nek	beteg 
beutaztató	be utaz tat ó	utaz
beütött	be üt ött	üt
bevetették	be vet ett ék	vet
bezárt	be zár t	zár
bírálat	bírál at	bírál
bizonyosodtak	bizony os od tak	bizony 
bizonyult	bizony ult	bizony
bizottsága	bizottság a	bizottság
biztonságát	biztonság át	biztonság 
biztonságos	biztonság os	biztonság 
biztosan	biztos an	biztos 
biztosított	biztos í tott	biztos 
blogbejegyzést	blog bejegyzés t	bejegyzés
bocsátkozott	bocsát koz ott	bocsát 
boltozatos	boltozat os	boltozat
Bomba	Bomba	Bomba
bombarobbantásokra	bomba robban tás ok ra	bomba 
bontotta	bont ott a	bont 
borítva	borít va	borít 
Borkonyha	Bor konyha	Bor 
borotva	borotva	borotva
bozótostól	bozót os tól	bozót
Brüsszelbe	Brüsszel be	Brüsszel
Brüsszeli	Brüsszel i	Brüsszel 
Budapesten	Budapest en	Budapest 
Budapesttől	Budapest től	Budapest 
bukik	bukik	bukik
büntetést	bün t et ést	bün 
bunyóval	bunyó val	bunyó 
buszbalesetnek	busz baleset nek	busz 
busz	busz	busz
büszkélkedhet	büszké l ked het	büszke
buszpályaudvarra	busz pálya udvar ra	busz
búzaexportőrei	búza export őre i	búza
céget	cég et	cég 
célra	cél ra	cél 
Changemakersnek	Changemakers nek	Changemakers 
Charleytól	Charley tól	Charley 
cikkből	cikk ből	cikk 
cikkek	cikk ek	cikk 
ciklon	ciklon	ciklon
ciklonja	ciklon ja	ciklon 
Ciklonok	Ciklon ok	Ciklon 
ciklus	ciklus	ciklus
ciklusra	ciklus ra	ciklus 
cím	cím	cím
cipeljenek	cipel je nek	cipel 
Coloradóban	Coloradó ban	Coloradó 
csak	csak	csak
csakhogy	csak hogy	csak 
családjainak	család ja i nak	család 
csapást	csapás t	csapás 
csapat	csapat	csapat
csapatoknak	csapat ok nak	csapat 
csata	csata	csata
cserkészeknél	cserkész ek nél	cserkész 
csökkenést	csökken és t	csökken 
csomagokat	csomag ok at	csomag 
csoportosíthatjuk	csoport os ít hat juk	csoport 
csúcsára	csúcs á ra	csúcs 
csúcstól	csúcs tól	csúcs 
csupa	csupa	csupa
csütörtök	csütörtök	csütörtök
csütörtöki	csütörtök i	csütörtök 
Cunami	Cunami	Cunami
darab	darab	darab
decemberében	december é ben	december 
délelőtti	dél előtt i	dél 
délig	dél ig	dél 
délnyugati	dél nyugat i	dél 
délt	dél t	dél 
délután	dél után	dél 
Demokratikus	Demokratikus	Demokratikus
derül	derül	derül
Dicső	Dicső	Dicső
díjnyertes	díj nyert es	díj 
díszes	dísz es	dísz
díszítenek	dísz ít e nek	dísz 
doktor	doktor	doktor
doktort	doktor t	doktor
dokumentumok	dokument um ok	dokument 
dolgozó	dolgozó	dolgozó
dolgozom	dolgoz om	dolgoz 
dolgoztak	dolgoz tak	dolgoz 
dollár	dollár	dollár
dolláros	dollár os	dollár 
dollárral	dollárr al	dollárr 
dombornyomott	domb or nyom ott	domb 
döntök	dönt ök	dönt 
Doshaliai	Doshalia i	Doshalia
drámaian	dráma i an	dráma 
Drónok	Drón ok	Drón 
drótkötélpályán	drót kötél pályá n	drót 
dúló	dúló	dúl
Dunántúlon	Dunántúl on	Dunántúl 
ebola	ebola	ebola
ebolajárvány	ebola járvány	ebola 
eboláról	ebolá ról	ebolá 
eddig	eddig	eddig
effajta	e ffajta	fajta
égbolt	ég bolt	ég 
éger	éger	éger
égettek	ég et tek	ég 
Eggy	Eggy	Eggy
Egy	Egy	Egy
egyenlore	egyenlo re	egyenlő
Egyesült	Egy es ül t	Egy
egyet	egy et	egy 
Egyetlen	Egy etlen	Egy 
egyezést	egy ez és t	egy 
egyformák	egy formá k	egy 
egymástól	egy más tól	egy 
Egymillió	Egy millió	Egy 
egységeinek	egység e i nek	egy
Egyszóval	Egy szó val	Egy 
együttműködést	egy ütt működés t	egy 
egzotikus	egzotik us	egzotikus
éjszakai	éj szaka i	éj
éjszakát	éj szaká t	éj
elaludni	el aludni	el
elalváshoz	el alvás hoz	el
elalvást	el alvás t	el 
Eleinte	Eleinte	Eleinte
elején	elejé n	eleje
elejétől	elejé től	eleje
El	El	El
él	él	él
élelem	élelem	élelem
élelmiszerárakat	élelmiszer ár ak at	élel
élelmiszerből	élelmiszer ből	élel
élelmiszerek	élelmiszer ek	élel
élelmiszer	élelmiszer	élel
elemzője	elem ző je	elem
elérhető	el érhet ő	ér
életed	él et e d	él
élettartama	él et tartam a	él 
életüke	él et ük e	él 
elfogták	el fogták	fogták
elfogyott	el fogy ott	fogy
elhagyniuk	el hagy ni uk	hagy
elhanyagolható	el hanyagol hat ó	hanyag
elítéli	el ítél i	ítél
eljárást	el jár ás t	jár
eljutottunk	el jut ott unk	jut
elkapás	el kap ás	kap
elkapható	el kap hat ó	kap
elkerülni	el kerüln i	kerüln
elkezdett	el kezd ett	kezd
elkezdődött	el kezd ő dött	kezd
elkezdődtek	el kezd ő dtek	kezd 
ellátórendszer	el lát ó rendszer	lát 
ellen	ellen	ellen
elleni	ellen i	ellen
ellenőrzésének	ellen őr zés é nek	ellen
ellentétben	ellen tét ben	ellen 
elmentek	el ment ek	ment
elmentünk	el ment ünk	ment
elmondani	el mond ani	mond
Elmondása	El mond ás a	mond
elmondható	el mond hat ó	mond
előállítására	elő áll ít ás á ra	áll
elõbb	elõbb	elõbb
Előbbiben	Előbb i ben	Előbb 
élőben	élő ben	él
elő	elő	elő
előfordul	elő fordul	elő
előfordult	elő fordul t	elő 
élők	élő k	él
elől	elő l	elő
elõrejelzések	elõre jelzés ek	elõre
élősködő	élő s köd ő	él
Eloszor	Eloszor	Eloszor
elosztására	el oszt ás á ra	oszt 
előtte	előtte	előtt
előzhető	el őz het ő	előz
elpusztítja	el pusztít ja	pusztít
elpusztult	el pusztul t	pusztul 
elsetaltunk	el setal t unk	setal
Elsőfokú	Első fok ú	fok
elsöpörtek	els öpört ek	söpör
Elsősorban	Első sor ban	sor
elszabadult	el szabad ul t	szabad
elszállítsák	el szállít sák	szállít
elszántságát	el szánt sá gát	elszánt
elszaporodni	el szaporod ni	szaporod 
eltérő	el tér ő	tér
eltöltöttünk	el töltöt t ünk	tölt
eltúloztam	el túloz tam	túloz
eltűnt	el tűn t	tűn
Elvben	Elv ben	Elv 
elvesztettem	el veszt ett em	veszt
elviekben	elv iek ben	elv
elvisel	el visel	visel
elvitte	el vitt e	vitt 
elvonult	el von ul t	von
emberekkel	ember ek kel	ember
ember	ember	ember
emberiség	ember i ség	ember
embernek	ember nek	ember
emberről	ember ről	ember 
embert	ember t	ember 
emelkedjen	emel ked jen	emel 
Emiatt	E miatt	miatt
Engedélyezési	Engedély e z é si	Engedély 
ennek	ennek	ennek
ennyi	ennyi	ennyi
Építészet	Épít ész et	Épít
építette	épít ett e	épít
építtette	építt ett e	építt 
éppen	éppen	éppen
épületegyüttesében	épül et egy ütt es é ben	épül
epuletekben	epul et ek ben	epul 
epuletektol	epul et ek tol	epul 
epulet	epul et	epul
erdei	erde i	erde
érdekelne	érdek el ne	érdek
Érdekes	Ér dek es	Ér
erdő	erdő	erdő
erdoirtasi	erdo irtas i	erdo 
erdőkre	erdő k re	erdő 
erdőtüzet	erdő tüz et	erdő 
erdőtűzveszélyes	erdő tűz veszély es	erdő 
erdőtűzzel	erdő tűz zel	erdő 
eredetileg	ered et i leg	ered
eredmény	ered mény	ered
ereje	ere je	erő
erejû	ere jû	erő
erejű	ere jű	erő
érésekor	érés e kor	ér
ereszkedett	ereszked ett	ereszked
érhetőek	ér het ő ek	ér
érhette	ér hett e	ér 
érik	ér ik	ér
Érintett	Érint ett	Érint
érintheti	érint het i	érint 
érintkezéssel	érint kez és sel	érint
érintkezett	érint kez ett	érint
érintkező	érint kez ő	érint 
érintkeztek	érint kez tek	érint 
érintő	érint ő	érint 
érkezett	érkez ett	ér
erőművek	erő műv ek	erő 
erõre	erõ re	erõ 
Erős	Erő s	Erő
erősödőben	erő s öd ő ben	erő 
erõsödött	erõ s öd ött	erõ 
erossegu	ero s seg u	ero 
erõsségû	erõ s ség û	erõ 
erõvel	erõ vel	erõ 
értékű	ér ték ű	ér 
értelmében	értel mé ben	értel 
ertem	ert em	ert 
ért	ért	ért
érti	ért i	ért 
értünk	ért ünk	ért 
eséllyel	esélly el	esélly
események	esemény ek	esemény
És	És	És
esetben	eset ben	eset 
eset	eset	eset
eshet	es het	es 
eső	eső	eső
esőt	eső t	eső 
esőzéseket	eső zés ek et	eső 
Este	Este	Este
estek	este k	este 
estig	est ig	est 
észak	észak	észak
eszközök	eszköz ök	eszköz 
eszközzel	eszköz zel	eszköz 
észlelt	észlel t	ész
eszünkbe	eszünk be	esz
ettől	ettől	ettől
Európából	Európá ból	Európá 
Európa	Európa	Európa
európaitól	európa i tól	európa 
evakuációs	evakuáció s	evakuáció 
évente	év ente	év 
év	év	év
évvel	év vel	év 
exportál	export ál	export 
extrém	extrém	extrém
Ezáltal	Ez által	által
Ezeket	Ezek et	Ez
ezelőtt	ez előtt	ez 
Ezreket	Ezre ket	Ez<e>r
ezt	ezt	ezt
ezúton	ez út on	út
ezzel	ez zel	ez 
Facebookon	Facebook on	Facebook 
fafaj	fa faj	fa 
fafajválasztással	fa faj választ á ssal	fa 
fagylalt	fagy lal t	fagy 
fagymentes	fagy mentes	fagy 
fájdalmat	fáj dal mat	fáj 
fáj	fáj	fáj
fákban	fák ban	fák 
fakidõlések	fa ki dõl és ek	fa
falait	fal a it	fal 
fal	fal	fal
faluban	falu ban	falu 
Falurekonstrukciós	Falu re konstrukció s	Falu 
falusiak	falu si ak	falu 
fedező	fed ez ő	fed
fedezték	fed ez ték	fed
fegyvergyártók	fegyver gyárt ó k	fegyver 
fejfájást	fej fájás t	fej 
fejlesztésére	fejleszt és é re	fejleszt 
fejleszt	fejleszt	fejleszt
fejsérülésekkel	fej sérül és ekk el	fej 
fejsérülést	fej sérül ést	fej 
fekvő	fek vő	fek 
feladattal	feladat tal	feladat 
felbukkan	fel bukkan	bukkan
felbukkant	fel bukkan t	bukkan
felébe	felé be	fel
félelmében	félelm é ben	fél
felelőssége	felelős ség e	felel
felelőtlen	felel ő t len	felel 
felesleges	felesleg es	feles
felfedezést	fel fedez és t	fedez
felhasználása	fel használ ás a	használ
felhasználói	fel használ ó i	használ
Felhőcunami	Felhő cunami	cunami
felhőkarcoló	felhő karcol ó	felhő
felhozatalával	fel hoz at a lával	hoz 
felismerni	fel ismer ni	ismer
felismerték	fel ismer t ék	ismer 
felkapom	fel kap om	kap 
felkészülni	fel készül ni	készül 
fellazították	fel lazít ott á k	lazít
Felnezek	Fel nez ek	nez 
felnőtt	fel nő tt	nő
félreértés	fél re ért és	ért 
Félszáz	Fél száz	száz
felszerelés	fel szer e lés	szer
feltámadó	fel támad ó	támad
feltárja	fel tár ja	tár
feltehetőleg	fel tehet őleg	tehet 
feltétele	fel tétel e	tétel
feltételekben	fel tétel ek ben	tétel 
féltucatnyi	fél tucat nyi	tucat 
felvegyék	fel vegyé k	vegyé
felvételeket	fel vétel ek et	vétel
felvezető	fel vezet ő	vezet
felvilágosítják	fel világos ít ják	világ
Fennáll	Fenn áll	áll
fenntartásához	fenn tart ás á hoz	tart 
fenntartható	fenn tart hat ó	tart 
férfit	férfi t	férfi 
fertőtlenített	fertő tlen í tett	fertő
fertőzési	fertő z és i	fertő
fertőzéskor	fertő z és kor	fertő 
fertőzést	fertő z és t	fertő 
fertőződik	fertő z ő dik	fertő
fertőzőképessé	fertő z ő képess é	fertő
fertőzőtt	fertő z őtt	fertő
fertőzővé	fertő z ő vé	fertő 
feszültségek	feszül t sé gek	feszül 
fiatalabb	fiatal abb	fiatal 
figyelembe	figyel em be	figyel 
figyelmet	figyel me t	figyel 
figyelmeztet	figyel me z tet	figyel 
figyelték	figyel t ék	figyel 
finanszírozása	finanszíroz á sa	finanszíroz 
finomkodott	finom kod ott	finom 
fiú	fiú	fiú
fiúk	fiú k	fiú 
Floridáig	Floridá ig	Floridá 
fogászati	fog ász at i	fog 
fogkefe	fog kefe	fog 
foglalkozó	fog lal koz ó	fog 
foglalták	fog lal t ák	fog 
fognak	fog nak	fog 
főként	fő ként	fő 
fokozatú	fok oz at ú	fok 
fokozott	fok oz ott	fok 
fokozták	fok oz ták	fok
föld	föld	föld
földrengései	föld reng és e i	föld 
földrengéseket	föld reng és ek et	föld 
foldrenges	fold reng es	fold 
földrengéshez	föld reng és hez	föld 
földrengésnek	föld reng és nek	föld 
fölött	föl ött	föl
folyadékhoz	folyadék hoz	foly
folyamatok	folyamat ok	foly
folyamatosan	folyamat os an	foly
folyamatos	folyamat os	foly
folyóiratban	folyó irat ban	foly
folyón	folyó n	foly
folytatja	foly tat ja	foly 
fonálférgesség	fonál férges ség	fér<e>g
fontosabb	fontos abb	fontos 
főorvos	fő orvos	orvos
fordítják	fordít ják	fordít 
fordultak	fordul tak	fordul 
főre	főre	fő
forgó	forg ó	for<o>g 
forgószelek	forg ó szelek	for<o>g 
forradalmak	forradal mak	forr
fortyogó	for tyog ó	for
fortyogott	for tyog ott	for 
Fórum	Fórum	Fórum
fosszilis	fosszil is	fosszil
fosztottak	fosztott ak	foszt
fotós	fotó s	fotó 
főúton	fő út on	út 
fővárosban	fő város ban	város
fővárosból	fő város ból	város
fõváros	fõ vár os	város
Franciaországban	Francia ország ban	Francia
Franciaország	Francia ország	Francia 
Friss	Friss	Friss
fújta	fúj t a	fúj 
fulladozva	full ad oz va	full 
Fuoco	Fuoco	Fuoco
Furcsa	Furcsa	Furcsa
furcsasága	furcsa ság a	furcsa 
gabonaárak	gabona árak	gabona 
Gárdát	Gárdá t	Gárdá 
Garowét	Garow ét	Garow
gátlása	gátlás a	gát
Gazdaság	Gazda ság	Gazda 
gazdasági	gazda ság i	gazda 
gazdaságnak	gazda ság nak	gazda 
gáz	gáz	gáz
generációnyi	generáció nyi	generáció 
Geológiai	Geológia i	Geológia 
geológusok	geológus ok	geológus 
Georgiában	Georgiá ban	Georgiá 
gépkocsi	gép kocsi	kocsi
globális	globális	globális
gomolygó	gomoly gó	gomoly 
gondatlanság	gond at lan ság	gond
gondoskodott	gond os ko dott	gond 
Görögországban	Görög ország ban	Görög 
Guatemalában	Guatemalá ban	Guatemalá 
guatemalai	guatemala i	guatemala 
Guineában	Guineá ban	Guineá 
gyakoriak	gyakori ak	gyakori 
gyakori	gyakori	gyakori
gyakorlatot	gyakorlat ot	gyakorlat 
gyakorolt	gyakorol t	gyakorol 
gyanúja	gyanú ja	gyanú 
gyengébb	gyengé bb	gyengé 
gyengülve	gyengül ve	gyengül 
gyerekeket	gyerek ek et	gyerek 
gyermekbénulás	gyermek bénul ás	gyermek 
gyermekedet	gyermek ed et	gyermek 
gyermekekért	gyermek ek ért	gyermek 
gyermeket	gyermek et	gyermek 
gyermekosztály	gyermek osztály	gyermek 
gyógyszerek	gyógy szer ek	gyógy 
gyógyszerszedés	gyógy szer szed és	gyógy 
gyönyörködött	gyönyör köd ött	gyönyör 
gyönyörködtetőek	gyönyör köd tet ő ek	gyönyör 
gyönyörűen	gyönyörű en	gyönyörű 
gyorsabban	gyors abb an	gyors 
gyors	gyors	gyors
gyötrik	gyötri k	gyöt<ör>
gyűjtés	gyűjt és	gyűjt
gyümölcs	gyümölcs	gyümölcs
gyűrű	gyűrű	gyűrű
hagyja	hagy j a	hagy 
hagytam	hagy tam	hagy 
ha	ha	ha
hajnalra	hajnal ra	hajnal 
halállal	halál l al	halál 
halálozás	halál oz ás	halál 
halász	hal ász	hal 
halottal	halo t tal	halott
halottról	halot t ról	halott
hamar	hamar	hamar
hamuréteg	hamu réteg	hamu 
hamuval	hamu val	hamu 
hangadója	hang adó ja	hang 
hangyak	hangy ak	hangya
hangzavart	hang zavar t	hang 
hanyadikra	hanyadik ra	hany
harcban	harc ban	harc
harmadik	harm adik	harm 
hármas	hárm as	hárm
háromkor	három kor	három 
háromszor	három szor	három 
hashtagen	hashtag en	hashtag 
hashtaget	hashtag et	hashtag 
Hasszán	Hasszán	Hasszán
használatának	használ at á nak	használ 
használatával	használ at á val	használ 
használni	használ ni	használ 
hasznosítása	hasznos ít á sa	hasznos 
határán	határ án	határ
határos	határ os	határ 
határozza	határ oz za	határ 
határt	határ t	határ 
hatásukat	hatás uk at	hatás 
hatékonyak	hatékony ak	hatékony 
hátránya	hát rány a	hát 
havat	ha vat	h<ó>
havazás	havaz ás	h<ó>
házadba	ház ad ba	ház
haza	haz a	haz 
házak	ház ak	ház 
hazaküldték	haza küld ték	haza 
hazánk	hazá nk	hazá 
hazauzenni	haz a uzenn i	haza 
házba	ház ba	ház 
háziorvost	házi orvos t	ház
háztömbök	ház tömb ök	ház 
hegyekből	hegy ek ből	hegy
hegyimentőknek	hegyi mentő k nek	hegy
hegyivezetőkkel	hegyi vezető k kel	hegy
hegymászókat	hegy mászó k at	hegy
helikopterek	helikopter ek	helikopter 
helikopter	helikopter	helikopter
helyek	hely ek	hely 
helyenként	helyen ként	hely
helyére	hely é re	hely
helyesbítette	helyes bít et te	helyes 
helyezkedik	helyez ked ik	hely
helyivel	hely i vel	hely 
helyrehozhatatlan	hely re hoz hat atlan	hely 
helyünk	hely ünk	hely 
helyzetnek	hely zet nek	hely 
henger	henger	henger
hepatitistől	hepatitis től	hepatitis 
hepatitisz	hepatitisz	hepatitisz
hetek	het ek	het 
héten	hét en	hét 
hétig	hét ig	hét 
héttagú	hét tag ú	hét 
hétvégén	hét végé n	hét 
hiányában	hiány á ban	hiány
hiányzik	hiány zik	hiány
hidegfront	hideg front	hideg 
hidegrekord	hideg rekord	hideg 
higanyszála	higany szál a	higany 
higiénés	higién és	higién 
hipszterei	hipszter ei	hipszter 
híradások	hír adás ok	hír 
híre	hír e	hír 
hírekhez	hír ek hez	hír 
Hírlevél	Hír levél	Hír 
hírt	hír t	hír 
hiszen	hisz en	hisz 
hivatalból	hivatal ból	hivatal 
hívta	hív ta	hív 
hogy	hogy	hogy
holttestekhez	holt testek hez	holt 
hónap	hó nap	hó
hónapok	hó nap ok	hó 
hónapokon	hó nap ok on	hó 
hónapokra	hó nap ok ra	hó 
hónapra	hó nap ra	hó 
honlapja	hon lap ja	hon 
hóolvadás	hó olvad ás	hó 
horgonyzott	horgony zott	horgony 
hosszabb	hossz abb	hossz 
hosszadalmas	hossz a dal mas	hossz 
hosszan	hossz an	hossz
hosszasan	hossz asa n	hossz 
hotelekben	hotel ek ben	hotel 
Hotel	Hotel	Hotel
hótömeg	hó tömeg	hó 
hóvihar	hó vihar	hó 
hozamuk	hoz am uk	hoz 
hoz	hoz	hoz
hozzáférésről	hozzá férés ről	hozzá 
hozzáférést	hozzá férés t	hozzá 
hozzáférnek	hozzá fér nek	hozzá 
hozza	hozz a	hozz 
huledeztek	huledez tek	huledez 
hullámok	hullám ok	hullám
Hurrikán	Hurrikán	Hurrikán
hurrikánközpont	hurrikán központ	hurrikán 
hurrikánszezon	hurrikán szezon	hurrikán 
húszéves	húsz éves	húsz 
húsz	húsz	húsz
húztak	húz ta k	húz 
ideje	ide je	ide 
időben	idő ben	idő 
időjárás	idő járás	idő 
időjárási	idő járás i	idő 
időjárást	idő járás t	idő 
időléptékét	idő lép ték ét	idő 
időre	idő re	idő 
Idősebb	Idő s ebb	Idő 
Idovel	Ido vel	Ido 
Igazgatóság	Igaz gat ó ság	Igaz 
igénybe	igény be	igény 
igényel	igény el	igény 
igyekeztek	igyekez tek	igyekez 
igy	igy	igy
illeti	illet i	illet 
illetve	illet ve	illet 
illúziói	illúzió i	illúzió 
ilyeneket	ilyen ek et	ilyen 
ilyenkor	ilyen kor	ilyen 
ilyet	ilyet	ilyet
imáink	imái nk	imái 
imám	imá m	imá
immunrendszere	immun rendszer e	immun 
import	import	import
Imrehegy	Imre hegy	Imre hegy
indonéziai	indonézia i	indonézia 
Indonéziát	Indonéziá t	Indonéziá 
indulnak	indul nak	indul 
indultunk	indul t unk	indul 
Infók	Infó k	Infó 
információkhoz	információ k hoz	információ 
inteligencia	inteligencia	inteligencia
intenzitása	intenzitás a	intenzitás 
intenzívebb	intenzív ebb	intenzív 
intenzív	intenzív	intenzív
interjú	interjú	interjú
intézkedések	intéz ked é sek	intéz 
ipar	ipar	ipar
Ipolytarnócnak	Ipolytarnóc nak	Ipolytarnóc 
Ipolytarnócon	Ipolytarnóc on	Ipolytarnóc 
iráni	irán i	irán 
iranyba	irany ba	irany 
irany	irany	irany
irasakor	ir as a kor	ir 
írásbeli	ír ás bel i	ír 
írás	ír ás	ír 
irodank	ir oda nk	ir 
írták	ír t á k	ír 
irtam	ir t am	ir
írtunk	ír t unk	ír 
Isfahani	Isfahan i	Isfahan 
is	is	is
iskolájának	iskolá já nak	iskolá 
iskolás	iskolá s	iskolá 
ismereteink	ismer et e ink	ismer 
ismerős	ismer ős	ismer 
istentisztelet	isten tisztel et	isten 
iszapkúpot	iszap kúp ot	iszap 
Iszlám	Iszlám	Iszlám
italt	ital t	ital 
ítéletidő	ítél et idő	ítél 
ítéltek	ítél t ek	ítél 
ivóvízellátása	ivó víz el lát ás a	víz
ivóvízellátás	ivó víz el lát ás	víz 
izgulhattuk	izgul hat tuk	izgul 
izlandi	izland i	izland 
Izlandon	Izland on	Izland 
január	január	január
Japánt	Japán t	Japán 
járnánk	jár ná nk	jár 
járókelők	jár ó kelő k	jár
járványt	járvány t	járvány 
járványügyi	járvány ügy i	járvány 
Járványveszély	Járvány veszély	Járvány 
JÁRVÁNYVESZÉLY	JÁRVÁNY VESZÉLY	JÁRVÁNY 
játszhatnak	játsz hat nak	ját
javítása	javít ás a	javít 
Jégeső	Jég eső	Jég 
jegy	jegy	jegy
jegyünket	jegyün k et	jegy
jelenleg	jelen leg	jelen 
jelenségnek	jelen ség nek	jelen 
jelentés	jelent és	jelent 
jelentette	jelent ett e	jelent 
jelentettek	jelent ett ek	jelent 
jelentőségű	jelent ős ég ű	jelent 
jelentsenek	jelent se nek	jelent 
jelesre	jeles re	jeles 
jelezni	jelez ni	jelez 
jelezte	jelez te	jelez 
jellemzi	jellem zi	jellem 
jellemző	jellem ző	jellem 
Jemenben	Jemen ben	Jemen 
jobbos	jobb os	jobb 
jogos	jogos	jogos
jogszerűtlen	jog szerű tlen	jog 
jóindulatú	jó indul at ú	indul
jöjjön	jöjj ön	jö
jonnek	jon nek	jo
jött	jött	jö
jöttünk	jött ünk	jö
jovahagyast	jova hagy as t	hagy
július	július	július
Június	Június	Június
jutni	jut ni	jut 
juttathatunk	jut tat hatunk	jut 
kalandot	kaland ot	kaland 
Kalkuttai	Kalkutta i	Kalkutta 
kamion	kamion	kamion
kantalva	kantal va	kantal 
kapcsán	kapcs án	kapcs 
kapcsolatban	kapcsol at ban	kapcsol 
kaphatta	kap hat t a	kap 
kar	kar	kar
károkat	kár ok at	kár 
Károkról	Kár ok ról	Kár
károsított	kár os í tott	kár
kártyavetők	kártya vető k	kártya 
kassai	kassa i	kassa 
Katasztrófa	Katasztrófa	Katasztrófa
katasztrófáknak	katasztrófák nak	katasztrófák 
katasztrófavédelem	katasztrófa véd elem	katasztrófa 
katasztrófavédelmi	katasztrófa véd elmi	katasztrófa 
katona	katona	katona
kedvelt	kedvel t	kedvel 
keleti	kelet i	kelet 
keményen	kemény en	kemény 
kéményre	kémény re	kémény 
Kéményseprőket	Kémény seprő k et	Kémény 
kényelmes	kényelm es	kényel<e>m 
képaláírás	kép alá írá s	kép 
képeit	kép e it	kép 
képek	kép ek	kép 
képekre	kép ek re	kép 
képtelen	kép telen	kép 
kérdésekben	kérdés ek ben	kérdés 
Kérem	Kér em	Kér 
keresik	keres ik	keres 
kérte	kér te	kér 
kerülése	kerül é se	kerül 
kerületében	kerül et é ben	kerül 
kerületi	kerül et i	kerül 
késések	késés ek	késés 
Később	Késő bb	Késő
későn	késő n	késő 
készített	kész ít ett	kész 
készülékekkel	kész ül ék ekk el	kész 
Keszult	Kesz ul t	Kesz 
készültség	kész ült ség	kész 
kétharmada	két harmad a	harmad 
kétharmadát	két harmad át	harmad 
kezdődik	kezd ő dik	kezd 
kezdődött	kezd ő dött	kezd
kezebe	kez e be	kez 
kezekben	kez ek ben	kez 
kezelni	kez el ni	kez 
kezeltek	ke zel t ek	kez
Kiadó	Ki ad ó	ad
kiadva	ki ad va	ad
kialakulása	ki alak ul ás a	alak 
kialakult	ki alakul t	alakul 
kiásni	ki ás ni	ás 
kicsit	kicsi t	kicsi 
Kiemelten	Ki emelt en	emelt
Kifogás	Ki fog ás	fog 
kifogyott	ki fogy ott	fogy 
kihúzható	ki húz hat ó	húz 
kijavították	ki javít ot t ák	javít
ki	ki	ki
kiküldték	ki küld ték	küld 
kilencen	kilenc en	kilenc
kilogramm	kilo gramm	gramm
kilométerre	kilo méter re	méter 
kimaradnia	ki marad ni a	marad
kimentunk	ki ment unk	ment 
kimondottan	ki mond ott an	mond 
kimozdulni	ki mozdul ni	mozdul
kimutattak	ki mutat tak	mutat 
kipréselődik	ki présel ő dik	présel
Kisded	Kis ded	ded
kisebb	kis ebb	kis
Kisetaltam	Ki setal tam	setal 
kisgyermek	kis gyermek	gyermek
kiszáradt	ki szárad t	ki szárad t
kitaláltam	ki talált am	ki talált am
kitöréskor	ki tör ésk or	ki tör ésk or
kitörésre	ki törés re	ki törés re
kitöréssel	ki törés sel	ki törés sel
kiválasztása	ki választ á sa	ki választ á sa
Kiválasztottak	Ki választot tak	Ki választot tak
klímatényező	klíma tényező	klíma tényező
Klunder	Klunder	Klunder
kockázatot	kockáz at ot	kockáz at ot
Kocsordról	Kocsord ról	Kocsord 
Kolleganom	Kollega nom	Kollega 
költöttek	költöt tek	költö
kolumbiai	kolumbia i	kolumbia 
kombinálva	kombinál va	kombinál 
Komi	Komi	Komi
kompközlekedés	komp közleked és	komp 
komplett	komplett	komplett
konkrét	konkrét	konkrét
könnyebbek	könnyeb bek	könnyeb 
konvoj	konvoj	konvoj
könyvet	könyv e t	könyv
koporsók	koporsó k	koporsó 
korabban	kor a bban	kor
korai	kor a i	kor 
Kora	Kora	Kor
körben	kör ben	kör 
körbeveszi	körbe vesz i	kör
korcsoportjaiban	kor csoport ja i ban	kor 
kordában	kordá ban	kordá 
kórházakat	kór ház ak at	kór
kórházat	kór ház at	kór
Kórházban­	Kór ház ban­	Kór
korlátozások	korlát oz ás ok	korlát 
körmendi	körmend i	körmend 
környékről	környék ről	körny
környező	kör nyez ő	körny
korokozó	kor okozó	kor 
körömvágó	köröm vág ó	köröm 
Korrekt	Korrekt	Korrekt
korú	korú	kor
körülményeit	körül mény e it	körül
köszönhető	köszön he tő	köszön 
Koszt	Koszt	Koszt
kötelezik	kötelez ik	kötelez
kötélre	kötél re	kötél 
követi	követ i	követ 
következhetnek	követ kez het nek	követ 
következik	követ kez ik	követ 
következménye	követ kez mény e	követ 
követően	követő en	követ
követõen	követõ en	követ
követség	követ ség	követ 
közelben	közel ben	közel
közelebb	közel ebb	közel 
közelébe	közel ébe	közel
közeléből	közel é ből	közel 
közeli	közel i	közel 
közepén	közep én	közep 
közepétől	közepé től	közep
kozkinccse	koz kinccs e	kinccs 
köz	köz	köz
közleményében	köz lemény é ben	köz 
közleménye	köz le mény e	köz 
közölte	közölte	közöl
közönséget	közönség et	köz
közösségi	közös ség i	köz
köztere	köz ter e	köz 
közt	közt	köz
közük	köz ük	köz 
közvetlen	köz vetlen	köz 
kráterébe	kráter ébe	kráter 
Krawczyknak	Krawczyk nak	Krawczyk 
küldheti	küld het i	küld 
küldte	küld te	küld 
külföldi	kül föld i	kül 
külföldinek	kül föld i nek	kül 
Külföld	Kül föld	Kül 
kulfoldrol	kul fold rol	kul 
kullancsok	kullancs ok	kullancs 
külön	külön	külön
kulonosen	kulonos en	kulono
külterületén	kül terület én	terület
kultúrákat	kultúrá kat	kultúrá 
kulturális	kulturá lis	kulturá 
külügyminisztérium	külügy minisztérium	minisztérium
Kungyangon	Kungyang on	Kungyang 
kupola	kup ola	kup 
kutakból	kutak ból	kut
kutatva	kutat va	kutat 
kutyákkal	kutyá kk al	kutyá
küzdelmet	küzd elm et	küzd
küzdenek	küzd e nek	küzd 
kyotói	kyotó i	kyotó 
lába	láb a	láb 
Lakástűz	Lakás tűz	Lakás 
lakosságának	lakos ság á nak	lak
lakosú	lak os ú	lak 
landolt	landol t	landol 
lankadnának	lankad ná nak	lankad 
lányokat	lány ok at	lány
lassan	lassan	lassan
látható	lát hat ó	lát 
latni	lat ni	lat 
látnivalók	látni való k	látni 
látogatása	lát og at á sa	lát
látogat	lát og at	lát 
látótáv	lát ó táv	lát 
latszik	lat szik	lat 
látszik	lát szik	lát 
láttad	lát tad	lát 
látták	lát ták	lát 
lattam	lat tam	lat 
látványa	lát vá nya	lát 
lávafolyamokkal	láva folyam ok kal	láva 
lavinában	laviná ban	laviná 
lázadás	lázad ás	lázad 
laza	laza	laza
lázzal	lázz al	láz
lecsökkentésében	le csökken t és é ben	csökke
lefolytatása	le foly tat á sa	foly 
legalábbis	legalább is	legalább 
legerõsebb	leg erõs ebb	erõs
legerősebbre	leg erős ebb re	erős 
leghosszabb	leg hossz abb	hossz 
Légierő	Légi erő	Lég
légitársaság	lég i társ as ág	lég
legnagyobb	leg nagy obb	nagy
legörgette	le görget te	görge
legrosszabbak	leg rossz abb ak	rossz
legtapasztaltabb	leg tapasztalt abb	tapasztalt
legtöbb	leg több	több
legvirulensebb	leg virulens ebb	virulens
legyünk	legyün k	legy
Légzőálarcban	Légző álarc ban	Lég
lehete	lehet e	lehet
lehetetlen	lehet et len	lehet 
lehetett	lehet ett	lehet 
lehet	lehet	lehet
lehetne	lehet ne	lehet
lehettek	lehet tek	lehet 
lejjebb	le jjebb	le 
lejutni	le jut ni	le 
leküzdéséhez	le küzdés é hez	küzdés 
le	le	le
lemaradt	le marad t	marad
lemez	le mez	lemez
lengedezett	leng edez ett	leng 
lenne	len ne	lenne
lenullazodik	le nullaz odik	nullaz 
lenyűgöző	le nyűgöz ő	nyűgöz
Lépcsőház	Lép cső ház	Lép 
lepcso	lep cso	lep 
lépne	lép ne	lép 
lerohantunk	le rohan t unk	rohan 
leszakított	le szakít ott	szakít 
leszállóegysége	le száll ó egy sé ge	száll 
lesz	lesz	lesz
leszögezni	le szögez ni	szögez 
létezik	lét ezik	lét 
lévő	lévő	lévő
levonulni	le vonul ni	vonul
levonulóban	le vonul ó ban	vonul 
lezárása	le zár ás a	zár
lezárni	le zár ni	zár
lezárták	le zár t ák	zár 
lezártnak	le zár t nak	zár 
lezúduló	le zúdul ó	zúdul
Lezuhant	Le zuhan t	zuhan
lezuhanva	le zuhan va	zuhan
link	link	link
litoszféra	litoszféra	litoszféra
logikájáról	logik ájá ról	logik 
lóg	lóg	lóg
lokális	lokális	lokális
lökés	lök és	lök 
Lombos	Lomb os	Lomb 
magasodó	magas odó	magas 
magasságban	magas ság ban	magas
magasságig	magas ság ig	magas 
magát	magá t	magá 
magmával	magmá val	magmá 
magnitúdója	magnitúd ó ja	magnitúdó 
magyarázta	magyaráz ta	magyaráz ta
Magyar	Magyar	Magyar
magyarokat	magyar ok at	magyar
mája	máj a	máj 
Majdnem	Majdnem	Majd nem
májgyulladást	máj gyullad ás t	máj
májtumor	máj tumor	máj 
Májusban	Május ban	Május
makacsul	makacs ul	makacs 
Malajziában	Malajziá ban	Malajziá 
maláriában	maláriá ban	maláriá 
maláriaprogramjának	malária program já nak	malária 
Maliban	Mali ban	Mali 
maradhatunk	marad hat unk	marad 
maradjanak	marad ja nak	marad 
mára	má ra	má 
Maridi	Marid i	Marid 
már	már	már
Marokkóból	Marokkó ból	Marokkó 
Másfélmillió	Másfél millió	Másfél 
máskor	más kor	más 
más	más	más
Másodfokú	Másod fokú	fokú
másodpercek	másod perc ek	perc 
mászókkal	mászókk al	mász
max	max	max
mecsetekbe	mecs et ek be	mecset 
mecset	mecs et	mecset
mecsetnek	mecs et nek	mecset 
meddig	meddig	meddig
médiában	médiá ban	médiá 
médiabeszámolók	média be számol ó k	média 
médium	médium	médium
megad	meg ad	ad
megakadályozni	meg akadály oz ni	akadály 
megállt	meg áll t	áll 
Megbénult	Meg bénul t	bénul 
megbeszélni	meg beszél ni	beszél 
megbetegedések	meg beteged é sek	beteg
megbetegedést	meg beteg ed és t	beteg 
megdöntötték	meg dönt ött é k	dönt 
megduplázódott	meg dupláz ódott	dupláz
megegyezés	meg egyez és	egy
megemlítem	meg említ em	említ 
megenyhült	meg enyhül t	enyh
megerősítik	meg erős ít ik	erő
megfelelően	meg fel elő en	felel
megfelelő	meg felel ő	felel 
meghaladja	meg halad ja	halad 
meghaladó	meg halad ó	halad
meghívja	meg hív ja	hív 
megígértem	meg ígér t em	ígér 
megismerkednünk	meg ismer ked nünk	ismer 
megjegyezhető	meg jegy ez het ő	jegyez 
megjelenhet	meg jelen het	jelen 
megjelennek	meg jelen nek	jelen 
megkaptam	meg kap tam	kap 
megközelítést	meg közelít és t	közel
megközelítették	meg közel ít ett ék	közel 
megközelítette	meg közelítet t e	közel
meglepetésszerûen	meg lepetés szerû en	lep
megmaradt	meg marad t	marad 
megnyitni	meg nyit ni	nyit
megoldani	meg old ani	old 
megoldjak	meg old ja k	old 
megölt	meg öl t	öl 
megoszlanak	meg oszla nak	oszl<o>l
mégpedig	még pedig	pedig
megpihenni	meg pihenn i	pihen
megpihentünk	meg pihen t ünk	pihen
megrongálódnak	meg rongál ó d nak	rongál 
megroppant	meg roppan t	roppan 
megsebesített	meg sebesít ett	seb
mégsem	még sem	sem
megszakította	meg szakít ott a	szakít
megszűnik	meg szűnik	szűn
megszüntetni	meg szünt et ni	szün
megtanulja	meg tanul ja	tanul 
megtett	meg tett	tett
megtisztítását	meg tisztít á sát	tisztít
megtudni	meg tud ni	tud
megtudtak	meg tud ta k	tud 
megúszták	meg úsz tá k	úsz
megyek	megye k	megye 
megy	megy	megy
megyunk	megy unk	megy 
megyünk	megy ünk	megy 
mekkorát	mekkor át	mekkor
méltónak	méltó nak	méltó 
melyből	mely ből	mely 
mélyen	mély en	mély 
mély	mély	mély
melyről	mely ről	mely 
menekültáradat	menekült áradat	menekül
menekült	menekül t	menekül 
Menj	Menj	Men
mennek	men nek	men 
mennyien	mennyi en	mennyi 
mennyire	mennyi re	mennyi 
mennyiségét	mennyi ség ét	mennyi 
mentési	mentés i	ment
mentést	mentés t	ment
mentette	ment ett e	ment 
menti	ment i	ment 
mentőalakulatok	mentő alakulat ok	ment
mentőszolgálat	mentő szolgál at	ment
merényletek	merénylet ek	merénylet
merénylő	merénylő	merénylő
mérföldre	mér föld re	mérföld 
Merje	Mer je	Mer
mérlegelték	mér leg el t ék	mér
mértek	mért ek	mér
mért	mér t	mér 
mesélte	mesél te	mesél
méteres	méter es	méter 
metró	metró	metró
mezőgazdasági	mező gazda ság i	gazda 
mezőgazdaság	mező gazda ság	gazda
Mianmarba	Mianmar ba	Mianmar 
mianmari	mianmar i	mianmar 
Miatyankot	Mi atyank ot	atyank
Miért	Mi ért	Mi
migránsáradat	migráns áradat	migráns 
MIGRÁNSOKAT	MIGRÁNS OK AT	MIGRÁNS 
mihamarabbi	mi hamar abb i	hamar
Mikor	Mi kor	kor
Mindenesetre	Minden eset re	eset 
mindenféle	mind en féle	mind
mindenképp	mind en képp	mind 
mindennapos	mind en nap os	mind 
mindent	mind en t	mind 
mindkét	mind két	mind
mindmáig	mind máig	mind 
Mindnyájunknak	Mind nyájunk nak	Mind 
minél	mi nél	mi 
minimum	minimum	minimum
miniszterelnök	miniszter elnök	miniszter 
mintegy	mint egy	egy
Mire	Mi re	Mi 
mit	mit	mi
mivé	mi vé	mi 
mobilitására	mobilitás ára	mobil
model	model	model
módja	mód ja	mód 
Mondtak	Mond ta k	Mond 
mondták	mond tá k	mond 
mondta	mond ta	mond 
monitoromon	monitor om on	monitor 
Mostanra	Most an ra	Most 
mozaikkal	mozaik kal	mozaik 
mozit	mozi t	mozi 
működik	mű ködik	működik
mulasztás	mulaszt ás	mulaszt 
múltán	múlt án	múlt 
Munkacsoport	Munka csoport	Munka 
munkája	munká ja	munká 
munkájukat	munká juk at	munká 
munkálatok	munká lat ok	munká
munkássága	munká s ság a	munká 
mutatják	mutat ják	mutat
mutat	mutat	mutat
mutatók	mutat ók	mutat 
mutatták	mutatt ák	mutatt 
mutatva	mutat va	mutat 
művelés	művel és	mű
műveletek	művel et ek	mű
művelt	művel t	mű
művészet	művész et	mű
Nagyhegyesen	Nagy hegyes en	hegyes
nagyító	nagy ít ó	nagy 
nagykövete	nagy követ e	követ
nagykövetségen	nagy követ ség en	követ 
nagyobbak	nagy obb ak	nagy
Nagyon	Nagy on	Nagy
nagysága	nagy ság a	nagy
nálunk	nálunk	nálunk
Napi	Nap i	Nap
napja	nap ja	nap
naplementét	nap lementé t	nap 
naponta	nap on ta	nap
napot	nap ot	nap
napszakban	nap szak ban	nap 
négyes	négy es	négy
négy	négy	négy
Nekünk	Nekünk	Nekünk
NÉLKÜL	NÉLKÜL	NÉLKÜL
Német	Német	Német
Németországban	Német ország ban	Német
nemzetgyűlés	nemzet gyűl és	nemzet 
ne	ne	ne
népegészségügyi	nép egész ség ügy i	egész 
népet	nép et	nép 
nevéhez	nev é hez	nev 
neveknek	nevek nek	nev
nevű	nev ű	nev 
nézd	néz d	néz 
nézegetni	néz e get ni	néz 
Norvégiához	Norvégiá hoz	Norvégiá 
nőstény	nőst ény	nő
növekvő	nö vek vő	nö 
növeli	növel i	nö
novemberi	november i	november
November	November	November
növényzet	növény zet	növény 
nyakamba	nyakam ba	nyakam 
nyaralás	nyar al ás	nyar
nyelven	nyelv en	nyelv 
nyerik	nyer ik	nyer
nyilatkozták	nyilatkoz ták	nyilatkoz 
nyíl	nyíl	nyíl
nyilváníto	nyilván ít o	nyilván 
nyílvánvaló	nyílván való	nyílván 
nyíregyházi	nyíregyház i	nyíregyház 
nyomán	nyom án	nyom
nyomóerő	nyom ó erő	nyom 
nyomóhatás	nyomó hatás	nyom
nyomon	nyom on	nyom 
Nyomozás	Nyom oz ás	Nyom
nyomtalanul	nyom talan ul	nyom 
nyugati	nyugat i	nyugat 
nyújtani	nyújt ani	nyújt 
nyújtott	nyújt ott	nyújt 
Ócsai	Ócsa i	Ócsa 
okozó	okoz ó	ok
okozott	okoz ott	ok
okozva	okoz va	ok
okozzák	okoz zák	ok
Oktatókórház	Oktató kór ház	Oktat
Ökumenikus	Ökumenikus	Ökumenikus
olasz	olasz	olasz
Olaszországban	Olasz ország ban	Olasz 
olcsó	olcsó	olcsó
oldalának	oldal á nak	oldal 
oldalára	oldal á ra	oldal 
oldalelmozdulásos	oldal el mozdul ás os	oldal 
oldalirányban	oldal irány ban	oldal 
oldalt	oldal t	oldal 
olimpiai	olimpia i	olimpia 
oltási	oltás i	olt
oltást	oltás t	olt
öltek	öl tek	öl 
oltórepülővel	oltó repülő vel	repülő 
öltözet	öltöz et	öltöz 
oltsunk	olt sunk	olt 
oltunk	olt unk	olt 
olvasztáshoz	olvaszt ás hoz	olvaszt 
olyan	olyan	olyan
olykor	olykor	olykor
Omani	Oman i	Oman 
Öngyilkos	Ön gyilkos	gyilkos
óráig	órá ig	órá 
óránként	órá nk ént	órá
órára	órá ra	órá 
órát	órá t	órá 
órával	órá val	órá 
orkán	orkán	orkán
örményt	örmény t	örmény 
örökölték	örök öl t ék	örök 
Orosz	Orosz	Orosz
Oroszország	Orosz ország	Orosz 
országainak	ország a i nak	ország 
országban	ország ban	ország 
Országjáró	Ország jár ó	Ország 
Országos	Ország os	Ország
örvénylik	örvény lik	örvény 
összefogassal	össze fog as s al	fog
összefoglalom	össze fog lal om	fog 
osszefutottam	ossze futott am	fut
osszefutottunk	ossze futott unk	fut
összegyűjteni	össze gyűjt en i	gyűjt 
ossze	ossze	ossze
összetartásukat	össze tartás u kat	tart
összetartó	össze tart ó	tart
ostromát	ostrom át	ostrom 
ösvényekről	ösvény ek ről	ösvény
Őszinte	Őszinte	Őszinte
oszlopot	oszlop ot	oszlop 
osztogatnak	oszt o gat nak	oszt 
osztrák	osztrák	osztrák
ötletet	ötlet et	ötlet 
ötletnek	ötlet nek	ötlet 
ötmillió	öt millió	millió
otodikrol	ot odik rol	ot 
otthagyták	ott hagyt ák	hagy
otthonban	otthon ban	otthon
ott	ott	ott
övezetben	övezet ben	övezet 
oxigén	oxigén	oxigén
pakoltak	pakol tak	pakol 
palackokat	palack ok at	palack 
pálmaolajtól	pálma olaj tól	olaj 
pályán	pályá n	pályá 
pályaudvaron	pálya udvar on	udvar
panaszokat	panasz ok at	panasz
papírlappal	papír lap pal	papír
Pápua	Pápua	Pápua
párizsi	párizs i	párizs 
parkban	park ban	park 
parkocska	park ocs ka	park 
parkoloig	parkolo ig	park
Párok	Pár ok	Pár 
partoknál	part ok nál	part 
partszakaszokon	part szakasz ok on	part 
parttalan	part talan	part 
patikabol	patika bol	patika
pattogva	pattog va	pattog 
pedig	pedig	pedig
példa	példa	példa
Pénteken	Péntek en	Péntek 
pénteki	péntek i	péntek 
penztarcamat	penz tarcam at	tarcam
perces	perc es	perc 
peremén	perem én	perem 
peremkerületeiben	perem kerület ei ben	perem 
pernyét	perny ét	pernyé
perzselő	perzsel ő	perzsel 
pesti	pest i	pest 
pihentető	pihent et ő	pihent 
pikantériát	pikantériá t	pikantériá 
piknikező	piknik ező	piknik
pillanatokon	pillanat ok on	pillanat 
pillantottunk	pillant ott unk	pillant 
pincéjébe	pincé jé be	pincé
pokolgépes	pokol gép e s	gép 
pokolgép	pokol gép	gép
polgármester	polgár mester	mester
Polinéziára	Polinéziá ra	Polinéziá
pompával	pompá val	pompá 
poprádi	poprád i	poprád 
porfelhőt	por felhő t	por
portrékák	portréká k	portréká 
Potenciálja	Potenciá lja	Potenciá 
pozitív	pozitív	pozitív
Próbáljuk	Próbál juk	Próbá
probara	proba ra	proba 
Problémái	Problémá i	Problémá 
programjaként	program ja ként	program 
programokon	program ok on	program
programok	program ok	program 
program	program	program
publikációban	publikáció ban	publikáció 
pulzusa	pulzus a	pulzus 
pusztítottak	pusztít ott ak	pusztít
pusztították	pusztít ot t ák	pusztít
ráakadtunk	rá akad t unk	akad
Rába	Rába	Rába
ragadt	ragad t	ragad 
rajzanak	rajza nak	raj
rakétatamádás	rakéta tamád ás	tamád
rakna	rak na	rak 
rakta	rak ta	rak 
reggel	reggel	reggel
régióban	régió ban	régió 
rejtélyes	rejtély es	rejtély
rejt	rejt	rejt
Rekorddöntő	Rekord döntő	Rekord 
rekord	rekord	rekord
remegni	remeg ni	remeg 
remeg	remeg	remeg
rémisztő	rémiszt ő	rém
rémülve	rémül ve	rém
rendelkező	rend el kez ő	rend 
rendőrség	rend őrség	rend 
rendszerére	rendszer é re	rend
rengesek	reng es ek	reng
reptérben	reptér ben	reptér 
reptéren	reptér en	reptér 
repülőn	repül őn	repül
repülőterein	repül ő ter e in	repül 
repülőterének	repül ő ter é nek	repül
repülőterét	repül ő ter é t	repül 
reszesei	resz es e i	resz 
részletekbe	rész let ek be	rész 
részleteket	rész let ek et	rész 
részletek	rész let ek	rész 
részvételt	rész vétel t	rész 
részvéttávirat	rész vét távirat	rész 
rétegeiben	réteg ei ben	réteg 
retteges	retteg es	retteg
riadót	riadó t	riadó 
riasztották	riaszt ott ák	riaszt 
riogatásként	riogat ás ként	riogat 
rizst	rizs t	rizs 
robbanásos	robban ás os	robban 
Robbanás	Robban ás	Robban
robbantanak	robban t anak	robban 
rohadék	rohad ék	rohad 
rohamokkal	roham ok kal	roham 
rohanó	rohan ó	rohan 
rohantak	rohan t ak	rohan 
rongált	rongál t	rongál 
roskadozo	roskad ozo	roskad 
rosszak	rossz ak	rossz 
rossz	rossz	rossz
rovarölőszert	rovar ölő szer t	rovar 
rovar	rovar	rovar
rövidebb	rövid ebb	rövid 
rövid	rövid	rövid
rúgna	rúg na	rúg 
ruhát	ruhá t	ruhá 
sárgaláz	sárga láz	láz
sarkvidéki	sark vidék i	vidék 
sebességű	seb esség ű	sebes
segélyben	segély ben	segély 
segélyirodát	segély irodá t	segély 
segélyprogramjának	segély program já nak	segély 
segélyt	segély t	segély 
segíteni	segít eni	segít 
segitettem	segit et tem	segit
segíti	segít i	segít 
segitséget	segit ség et	segit 
segítségét	segít ség ét	segít 
sejtem	sejtem	sej
sejtfelszíni	sejt felszín i	sejt 
selyemút	selyem út	selyem 
sérülésekkel	sérülés ek kel	sérül
sérültet	sérült et	sérül
se	se	se
seta	seta	seta
sikeresen	siker es en	siker
sikerült	siker ült	siker 
síkság	sík ság	sík
Síliftről	Sí lift ről	Sí 
sírokhoz	sír ok hoz	sír 
sisak	sisak	sisak
Skóciában	Skóciá ban	Skóciá 
sokak	sok ak	sok 
sokba	sok ba	sok 
sokkal	sok kal	sok 
sokszor	sok szor	sok 
söpör	söpör	söpör
során	sor án	sor 
sorba	sor ba	sor
sorozat	sor oz at	sor 
sorra	sor ra	sor
sorrendjét	sor rend jét	sor 
spanyolok	spanyol ok	spanyol 
Spanyolországban	Spanyol ország ban	Spanyol 
specifikus	specifikus	specifikus
Spitzbergák	Spitzberg ák	Spitzbergák
sportág	sport ág	sport
sportarénában	sport aréná ban	sport 
sportbiztosítással	sport biztosítás s al	sport 
sport	sport	sport
stadionjaira	stadion ja i ra	stadion 
statisztikák	statisztiká k	statisztiká 
Strombolihoz	Stromboli hoz	Stromboli 
Strombolit	Stromboli t	Stromboli 
sugarú	sugar ú	sugar
sújtja	sújt ja	sújt 
sújtó	sújt ó	sújt 
sújtottak	sújt ott ak	sújt 
sújtott	sújt ott	sújt 
sulyos	suly os	suly 
sürgősségi	sürgős ség i	sürgős 
szabadságot	szabad ság ot	szabad 
szabadulnak	szabad ul nak	szabad 
szabadul	szabad ul	szabad 
szabadult	szabad ul t	szabad 
szakadva	szakad va	szakad 
szakaszában	szak asz á ban	szakasz 
szakasznak	szak asz nak	szakasz 
szakaszon	szak asz on	szakasz
szakemberei	szak embe re i	embe
Szakértők	Szak értő k	ért
szállítható	szállít hat ó	száll
szállítmányt	szállít mány t	száll
szállító	szállít ó	száll
szállóban	szálló ban	száll
szállodai	szálloda i	száll
számára	szám ára	szám 
számítani	szám ít ani	szám
számolni	szám ol ni	szám
Számos	Szám os	Szám
számukra	számuk ra	szám
Számunkra	Számunk ra	Szám
száradva	szárad va	szárad 
szárazabbá	száraz abb á	száraz
származnak	származ nak	származ 
szarvasmarha	szarvas marha	marha
szavait	szava i t	sza
szavaival	szava i val	sza
Szavazás	Szavaz ás	Sza
Századából	Századá ból	Száz
százak	száz ak	száz 
százalékkal	száz alékk al	száz 
százötven	száz ötven	száz 
szedi	szed i	szed 
széfben	széf ben	széf
széklettel	szék lett el	széklet
szektorban	szektor ban	szektor
szelenek	szel e nek	szel
szélén	szélé n	szél
széléről	szélé ről	szél
széllökésekkel	szél lökés ekk el	szél 
szel	szel	szel
szembenézniük	szembe nézni ük	szem
személyautó	személy autó	autó
személyazonosságát	személy azonos ság át	személy 
személyes	személy es	személy 
személyzetből	személy zet ből	személy 
szemetelünk	szemet e lünk	szemet 
szempontból	szem pont ból	szem
Szemtanúk	Szem tanú k	Szem 
szemtanú	szem tanú	szem 
szemüveggel	szem üvegg el	szem 
szennyező	szenny ez ő	szenny 
szennyt	szenny t	szenny 
szentély	szen tély	szent
szentgotthárdi	szentgotthárd i	szentgotthárd 
Szent	Szent	Szent
szepen	szep en	szep 
szépségét	szép ség ét	szép 
Szép	Szép	Szép
szerdára	szerdá ra	szerdá 
szerda	szerda	szerda
szerencsére	szerencsé re	szerencsé 
szerencsétlenség	szerencsé tlen ség	szerencsé 
szerepet	szerep et	szerep 
szeretet	szeret et	szeret 
szeretné	szeret né	szeret 
szerezhetünk	szerez het ünk	szerez 
szerin	szerin	szerin
Szerintem	Szerint em	Szerint 
Szerint	Szerint	Szerint
Szerintünk	Szerint ünk	Szerint 
szerkesztőknek	szerkeszt ő k nek	szerkeszt 
szer	szer	szer
szertartása	szer tartás a	szer
Szervezetének	Szervez et é nek	Szerv
szervezőjét	szervez ő jét	szerv
szerv	szerv	szerv
szétfolyva	szét foly va	foly 
szétzúzott	szét zúz ott	zúz 
szigetcsoport	sziget csoport	sziget 
szilveszterezni	szilveszter ez ni	szilveszter 
színgazdag	szín gazdag	gazdag
szívderítő	szív derít ő	szív
szívós	szív ós	szív 
szóban	szó ban	szó
szobát	szobá t	szobá 
Szocsiban	Szocsi ban	Szocsi 
szökött	szök ött	szök 
Szolgálat	Szolgál at	Szolgál 
szolgál	szolgál	szolgál
szolo	szolo	szol
szól	szól	szól
szólt	szól t	szól 
szólva	szól va	szól
Szomáliai	Szomália i	Szomália 
szombati	szombat i	szombat 
szombaton	szombat on	szombat 
szombat	szombat	szombat
Szörnyű	Ször nyű	Ször 
szorosan	szoros an	szoros 
szó	szó	szó
szoval	szo val	szo 
Szövetségi	Szövetség i	Szövetség 
szövődményeibe	szövőd mény e ibe	szö
szubjektíven	szubjektív en	szubjektív 
szudánban	szudán ban	szudán 
szuk	szuk	szuk
szűk	szűk	szűk
szülei	szül e i	szül 
született	szül et ett	szül
szupravezető	szupra vezető	vezető
szurkolhattunk	szurkol hat tunk	szurkol
tagja	tag ja	tag 
tag	tag	tag
tájékoztatást	tájék oztat ás t	tájék
tájfunná	tájfun ná	tájfun 
talajra	talaj ra	talaj 
talajt	talaj t	talaj 
találtak	talált ak	talál
támadások	támad ás ok	támad 
támogatások	támogat ás ok	tám
támogathatja	támogat hat ja	tám
tanácsadója	tanács adó ja	tanács 
tanácsokat	tanács ok at	tanács
tanácsolták	tanács ol t ák	tanács 
tanítsd	tan ít sd	tan 
tapasztalták	tapasztal ták	tapasztal 
tapasztalt	tapasztal t	tapasztal 
tárcsázza	tárcsáz za	tárcsáz 
tárgyaid	tárgy a i d	tárgy 
tárgyak	tárgy ak	tárgy
tarolt	tarol t	tarol
társadalmi	társadalm i	társadalm
társainak	tár sa i nak	társ
társasház	társas ház	társ
társa	társ a	társ 
tartalmaznak	tart alma z nak	tart 
tartanak	tarta nak	tart
tartják	tart já k	tart 
tartósan	tartós an	tart
tartós	tart ós	tart
tartó	tart ó	tart 
tartottak	tart ot tak	tart 
tartozik	tart oz ik	tart 
tartsák	tart sák	tart 
tart	tart	tart
tátralomnici	tátralomnic i	tátralomnic 
tavalyi	tavaly i	tavaly 
tavaszias	tavasz i as	tavasz 
tavaszi	tavasz i	tavasz 
távolodó	távol odó	táv
tavol	tavol	tav
távoznak	táv oz nak	táv 
teafőzőt	tea főző t	főz
teasüteményeket	tea sütemény e ke t	süt
tehát	tehát	tehát
tekert	teker t	teker 
tekintem	tekint em	tekint 
tektonikai	tektonika i	tektonika 
Telefonalni	Telefon al ni	Telefon
telefonomat	telefon om at	telefon 
telefonos	telefon os	telefon 
telefonszámait	telefon száma i t	telefon 
telep	telep	telep
települése	telep ülés e	telep
települést	telep ül és t	telep 
televíziós	televízió s	televízió 
televízió	televízió	televízió
teljében	teljé ben	tel
teljen	teljen	tel
Teljesen	Teljes en	Tel
teltházzal	telt házz al	tel
tengenek	teng enek	teng
tengeren	tenger en	tenger 
tengerfelszín	tenger felszín	tenger 
tengerparti	tenger part i	tenger
tengerpartján	tenger part ján	tenger
tengerpart	tenger part	tenger 
tengervíz	tenger víz	tenger 
ténylegesen	tény leg es en	tény 
tépázta	tépáz ta	tép
terek	ter e k	ter
terhelve	terhel ve	terhe
terhet	terhe t	terhe 
terjedését	terjed és ét	terjed
terjedési	terjed és i	terjed 
terjedő	terjed ő	terjed 
terkepen	ter kep en	ter 
térképezték	térkép ezt ék	tér
terményveszteség	termény vesztes ég	term
termésben	termés ben	term
termés	termés	term
természet	termész et	term
termőterület	termő terület	term
térre	té rre	tér
terrorizmusa	terrorizmus a	terror
terrorizmus	terror izmus	terror 
térségét	tér ség ét	tér 
térség	tér ség	tér 
területeken	terül e te ken	terül
területeket	terül et ek et	terül 
területekre	terül et ek re	terül 
területek	terül et ek	terül 
területen	terül et en	terül 
területe	terül et e	terül 
területet	terül et e t	terül 
területig	terül et ig	terül 
terül	terül	terül
tervezte	ter ve zte	terv
tesszük	tessz ük	tessz 
testnedvek	test nedv ek	nedv
testvérvárosa	testvér város a	város 
teszi	tesz i	tesz 
tesznek	tesz nek	tesz 
teszteket	teszt ek et	teszt 
tesz	tesz	tesz
tetejére	te te jére	teteje
tetejét	tetejé t	tetejé
tetemes	tetem es	tetem
tetézhet	tetéz het	tetéz 
tetőszerkezetét	tető szerkezet ét	tető 
Tetszett	Tetszet t	Tetszet 
tett	tett	tett
tévéadók	tévé adó k	tévé 
tévében	tévé ben	tévé 
tevednek	teved nek	teved 
Tífusz	Tífusz	Tífusz
TÍFUSZ	TÍFUSZ	TÍFUSZ
tiltakozásképpen	tilt akozás képpen	tilt 
típusai	típus a i	típus
tiszta	tiszta	tiszta
tiszteletteljesen	tisztel et teljes en	tisztel 
tisztelt	tisztel t	tisztel 
tisztít	tisztít	tiszt
tisztviselő	tiszt viselő	tiszt 
titokban	titok ban	titok 
Tizenöt	Tiz en öt	Tiz 
tízezer	tíz ezer	tíz 
tízmillió	tíz millió	tíz 
tóban	tó ban	tó 
többen	töb ben	több
tobbieket	tobb i ek et	tobb 
többieknél	több i ek nél	több 
Tökéletesen	Tökéletes en	Tökéletes 
tökéletesre	tökéletes re	tökéletes 
tökéletes	tökélet es	tökélet 
tole	tole	tole
tőle	tőle	tőle
tombolását	tombol ás át	tombol
tömege	tömeg e	tömeg 
tömény	tömény	tömény
tönkre	tönk re	tönk 
tonna	tonna	tonna
topikban	topik ban	topik 
torkába	torká ba	torká 
Tornádó	Tornádó	Tornádó
törölközőn	törölköz őn	törölköz 
törtek	tör t ek	tör 
történetéből	törté ne t é ből	történ 
történő	történ ő	történ
törzsön	törzs ön	törzs 
tó	tó	tó
továbbadott	tovább ad ott	ad 
tovabba	tovabb a	tovabb
továbbiak	tovább i ak	tovább 
további	tovább i	tovább 
tragikusabb	tragikus abb	tragikus 
tűalomban	tű alom ban	alom 
tucatnyi	tucat nyi	tucat 
tudnivalók	tudni valók	tud
tudományért	tudomány ért	tud
tudományos	tud om ány os	tud 
tudósok	tudós ok	tud
tudós	tudós	tud
tudta	tudta	tud
tudtunk	tud t unk	tud
túlélőknek	túl él ők nek	él 
Túlélte	Túl élte	él
túloldaláról	túl oldal á ról	oldal
túl	túl	túl
túlzottan	túl zot t an	túl
tumorja	tumor ja	tumor
tűnik	tűnik	tűnik
túravezetőinek	túra vezet ő i nek	vezet
túravezető	túra vezet ő	vezet
Tűzharc	Tűz harc	harc
tűzkárért	tűz kár ért	kár 
tűzkárok	tűz kár ok	kár 
tűzkárral	tűz kár ral	kár 
tűzoltóknak	tűz oltó k nak	oltó
tűzoltórepülők	tűz oltó repülő k	repülő 
twitteren	twitter en	twitter 
ugyanannak	ugyan annak	annak
ugyancsak	ugyan csak	ugyan
Ugyanez	Ugyan ez	Ugyan 
ügyekre	ügy ek re	ügy 
ugye	ugye	ugy
ugyis	ugy is	ugy 
ujabb	ujabb	uj
Újdelhiben	Újdelhi ben	Újdelhi 
újraépítésére	újra építés é re	építés 
újra	új ra	új 
Újra	Új ra	Új 
új	új	új
Újvidéktől	Újvidék től	Újvidék 
ukrajnai	ukrajna i	ukrajna 
ukrán	ukrán	ukrán
ülésén	ülés én	ülés 
ultramélyhűtőkre	ultra mély hűtő k re	hűtő
uralkodása	ural kod á sa	ural 
üregbe	üreg be	üreg
úr	úr	úr
üstökös	üstök ös	üstök
úszta	úsz ta	úsz 
utakat	ut ak at	ut
utak	ut ak	ut 
utalt	utal t	utal 
Utana	Utana	Utana
utána	utána	utána
utasításainak	uta sít ás a i nak	ut
utassal	utas sal	ut
utat	ut at	ut 
utazást	ut az ás t	ut 
Utazni	Utaz ni	Ut
utca	ut ca	ut 
útjában	útjá ban	út
útjain	út ja in	út 
ütközött	ütköz ött	ütköz 
Útlezárás	Út lezár ás	zár
Utóbbi	Utóbb i	Utó
utoljára	utoljá ra	uto
utorengesen	uto renges en	renges
út	út	út
utvonalon	ut vonal on	ut 
üveget	üve get	üveg
üveg	üveg	üveg
uzletekhez	uzlet ek hez	uzlet 
uzletek	uzlet ek	uzlet 
Üzleti	Üzlet i	Üzlet 
vágnak	vág nak	vág 
vagyis	vagy is	vagy 
Vajon	Vaj on	Vajon
vakkantást	vakkant ást	vakkant 
vak	vak	vak
valakit	valaki t	valaki 
valamilyen	valamilyen	valamilyen
váljanak	vál ja nak	vál 
válni	vál ni	vál 
valóban	való ban	való 
valójában	való já ban	való 
Valószínűleg	Való színű leg	Való
valószínűsége	való színű sé ge	való 
való	való	való
valtjak	valt ja k	valt
változata	vált ozat a	vált 
Vank	Vank	Vank
várhatóak	vár hat ó ak	vár 
várhatók	vár hat ó k	vár
várható	vár hat ó	vár 
várnak	vár nak	vár 
városában	vár os á ban	város 
városához	vár os á hoz	város
városát	vár os át	város 
városkát	vár os kát	város 
városnak	vár os nak	város
városnegyedében	város negyed é ben	város 
városokba	vár os ok ba	vár 
városok	vár os ok	vár 
városra	vár os ra	vár 
várost	vár os t	vár 
várták	vár t ák	vár 
vasárnap	vasárnap	vasárnap
vasútállomáshoz	vasút állomás hoz	vasút 
védekeznek	véd ekez nek	véd
Védjük	Véd jük	Véd 
védnöksége	véd nökség e	véd 
véd	véd	véd
végében	végé ben	vég
végétől	végé től	vég
véget	vége t	vég
vege	veg e	veg 
végeztek	vég ez tek	vég 
végigmegy	vég ig megy	vég 
vegigsoportek	veg ig sopor tek	veg 
végtagi	vég tag i	vég 
végtelen	vég telen	vég 
Végülis	Vég ül is	Vég 
végül	vég ül	vég 
Végzetes	Vég zet es	Vég 
véletlen	véletlen	véletlen
véli	vél i	vél 
velük	velük	velük
vendégeknek	vendég ek nek	vendég 
Venfeng	Venfeng	Venfeng
venni	venni	venni
véráramba	vér áram ba	vér
verseny	verseny	verseny
veszélye	veszély e	veszély 
veszélyezteti	veszély ez tet i	veszély
veszélyt	veszély t	veszély 
veszett	vesz ett	vesz
veszik	vesz ik	vesz 
veszített	veszít ett	vesz
veszi	vesz i	vesz 
veszteségei	veszt eség e i	vesz
vesztették	veszt ett ék	vesz
vesztette	veszt ett e	vesz
vetik	vet ik	vet
vettek	vet tek	vet 
vette	vet te	vet 
vettünk	vet tünk	vet 
vezetővel	vezet ő vel	vezet 
vidám	vidám	vidám
Videken	Videk en	Videk 
videókat	videó kat	videó 
Videó	Videó	Videó
viharát	vihar át	vihar 
viharos	vihar os	vihar 
viharrá	vihar rá	vihar 
Világgazdaság	Világ gazda ság	gazda 
világszervezete	világ szervezet e	szervezet
világ	világ	világ
Vilma	Vilma	Vilma
vinni	vinni	vinni
virradóra	virrad óra	virrad 
vírusba	vírus ba	vírus 
vírusfertőzés	vírus fertőzés	vírus 
vírusnak	vírus nak	vírus 
viseltek	visel tek	visel 
viskok	visko k	visko 
visszább	visszá bb	visszá
visszahúzódóban	vissza húz ó dó ban	húz
visszahúzódtak	vissza húzód tak	húz
Visszatérhet	Vissza tér het	tér 
visszatérjenek	vissza tér je nek	tér 
visszatérnek	vissza tér nek	tér 
Vissza	Vissza	Vissza
viszonyai	viszony a i	viszony 
viszonyok	viszony ok	viszony 
vízből	víz ből	víz 
vízhőmérséklet	víz hőmér séklet	víz 
vizsgabiztosai	vizsga biztos a i	biztos 
vízszintet	víz szint et	víz 
Vízügyi	Víz ügy i	Víz
víz	víz	víz
vízzel	víz zel	víz 
Vőlegénye	Vő legény e	legény 
völgykatlanba	völgy katlan ba	völgy
volna	volna	volna
vonultak	vonul tak	vonul 
vonult	vonul t	vonul
vorkutai	vorkuta i	vorkuta 
vulkánból	vulkán ból	vulkán 
vulkáni	vulkán i	vulkán 
vulkánt	vulkán t	vulkán 
Wilayatban	Wilayat ban	Wilayat 
Yongonban	Yongon ban	Yongon 
zajló	zaj ló	zaj 
záporok	zápor ok	zápor
zárta	zár t a	zár
zárultak	zár ul t ak	zár 
zóna	zóna	zóna
Zuckermantól	Zuckerman tól	Zuckerman 
zúdult	zúdul t	zúdul 
zuhanóbombázó	zuhan ó bombáz ó	bombáz 
zuhant	zuhan t	zuhan 
zuhanyzó	zuhany zó	zuhany 
