token	segmentation	root
ada	ada	ada
Adai	A dai	dai
adha	adha	adha
adhuhuri	adhuhuri	adhuhuri
afisa	afisa	afisa
afunguka	a fungu k a	fungu
agizo	agiz o	agiz 
Aidha	Aidha	Aidha
ajira	ajira	ajira
ajisalimisha	a ji salim ish a	salim
AKABIDHI	A KABIDHI	KABIDHI
akatisha	a ka tish a	tish
akaunti	a kaunti	kaunti
akieleza	a ki elez a	elez
Akifafanua	A ki fafanu a	fafanu
akifanya	a ki fany a	fany
akifurahia	a ki furahi a	furahi
akihudhuria	a ki hudhuri a	hudhuri
akikabidhi	a ki kabidhi	kabidhi
akiomba	a ki omb a	omb
Akiongea	A ki onge a	onge
akionyesha	a ki o ny esh a	ny
akipongeza	a ki pong ez a	pong
Akiri	A kiri	kiri
akisema	a ki sem a	sem
akisherehekea	a ki shereh ek e a	shereh
akisimulia	a ki simu li a	simu
akisubiri	a ki subiri	subiri
akitoa	a ki to a	to
akiwemo	a ki wemo	wemo
Akizungumzia	A ki zungum z i a	zungum
akthari	akthari	akthari
Alhamisi	Alhamisi	Alhamisi
aliahidi	a li ahidi	ahidi
aliambia	a li amb i a	amb
alieleza	a li elez a	elez
Alifafanua	A li fafanu a	fafanu
aliitaka	a li i tak a	tak
alikutwa	a li kut w a	kut
Alikuwa	A li kuw a	kuw
aliliambia	a li li amb i a	amb
alilitaarifu	a li li taarifu	taarifu
alinukuu	a li nu kuu	kuu
alioandika	a li o andik a	andik
aliona	a li on a	on
alipaswa	a li pas w a	pas
alipokuwa	a li po kuw a	kuw
alipoleta	a li po let a	let
alipoteza	a li pot ez a	pot
alisisitiza	a li sisitiz a	sisitiz
alisombwa	a li somb w a	somb
alitoa	a li to a	to
Alivitaja	A li vi taj a	taj
alivitaka	a li vi tak a	tak
alivyo	a li vyo	vyo
alivyotaarifu	a li vyo taarifu	taarifu
Aliwaomba	A li wa omb a	omb
aliwasifu	a li wa sif u	sif
Aliwekwa	A li wek w a	wek
Aliweza	A li wez a	wez
aliyeambukizwa	a li ye ambu k iz w a	ambu
aliyekufa	a li ye kuf a	kuf
aliyekuwa	a li ye kuw a	kuw
aliyemtishia	a li ye m tish i a	tish
aliyemtolea	a li ye m tol e a	tol
Aliyeolewa	A li ye o lew a	lew
aliyeweza	a li ye wez a	wez
aliyo	a li yo	li
aliyopewa	a li yo p<e> w a	p<e>
aliyoyapata	a li yo ya pat a	pat
ama	ama	ama
ambako	amba ko	amba
ambalo	amba lo	amba
ambavyo	amba vyo	amba
ambaye	amba ye	amba
ameahidi	a me ahidi	ahidi
ameenda	a me end a	end
amegunduliwa	a me gundu liw a	gundu
ameishi	a me ishi	ishi
amejiuzulu	a me ji uzulu	uzulu
amekutana	a me kut an a	kut
amekuwa	a me kuw a	kuw
amekwama	a me kwam a	kwam
amelaani	a me laani	laani
ameliambia	a me li amb i a	amb
amembeba	a me m beb a	beb
amemzuia	a me m zui a	zui
ameomba	a me omb a	omb
ameondoa	a me ondo a	ondo
ameonesha	a me on esh a	on
Ameongeza	A me ongez a	ongez
ameonya	a me ony a	ony
Amesema	A me sem a	sem
amesikika	a me sik ik a	sik
amesikitishwa	a me sikit ish w a	sikit
amesimama	a me simam a	simam
Ametangaza	A me tangaz a	tangaz
ametoa	a me to a	to
Amewahakikishia	A me wa hakik ish i a	hakik
amewahi	a me wahi	wahi
amezuia	a me zui a	zui
amezuru	a me zuru	zuru
amri	amri	amri
ana	a na	na
Anaeleza	A na elez a	elez
anakuja	a na kuj a	kuj
anaomba	a na omb a	omb
anaongoza	a na ongoz a	ongoz
anapoendesha	a na po end esh a	end
anarudi	a na rudi	rudi
Anasema	A na sem a	sem
anatarajiwa	a na taraji w a	taraji
anatibiwa	a na tibi w a	tibi
anatokwa	a na tok w a	tok
anaugua	a na ugu a	ugu
anawaomba	a na wa omb a	omb
anayejua	a na ye ju a	ju
anayeshukiwa	a na ye shuki w a	shuki
angalia	angali a	angali
angani	anga ni	anga
Ardhi	Ardhi	Ardhi
arobaini	arobaini	arobaini
arudi	a rudi	rudi
arudishwa	a rud ish w a	rud
asiendelee	a si endele e	endele
asilia	a sili a 	sili
asiongee	a si onge e	onge
asipite	a si pit e	pit
asiyefahamika	a si ye faham ik a	faham
atakayekiuka	a ta ka ye kiu k a	kiu
Atakayetoa	A ta ka ye to a	to
athari	athari	athari
atiwa	a tiw a	tiw
Atlantiki	Atlantiki	Atlantiki
au	au	au
Awali	Awali	Awali
AZIMIO	AZIM I O	AZIM
baa	baa	baa
baada	baada	baada
Baadaye	Baada ye	Baada
badala	badala	badala
bahari	bahari	bahari
baharini	bahari ni	bahari
bakiteria	bakiteria	bakiteria
balaa	balaa	balaa
balozi	balozi	balozi
bara	bara	bara
barabara	bara bara 	bara 
barani	bara ni	bara 
Bastola	Bastola	Bastola
be	be	be
Bi	Bi	Bi
biashara	biashara	biashara
Bidhaa	Bidhaa	Bidhaa
bila	bila	bila
binadamu	binadamu	binadamu
bintiye	binti ye	binti
bioteknolojia	bioteknolojia	bioteknolojia
bomba	bomba	bomba
Bonde	Bonde	Bonde
Brigedia	Brigedia	Brigedia
Bunge	Bunge	Bunge
bure	bure	bure
chache	ch ache 	ache 
CHAFU	CHAFU	CHAFU
changamoto	changa moto	moto
changarawe	changa rawe 	rawe 
chini	chini	chini
chombo	ch ombo	ombo
chote	ch ote	ote
chuo	chuo	chuo
chupa	chupa	chupa
dafu	dafu	dafu
Dalili	Dalili	Dalili
daraja	daraja	daraja
dawa	dawa	dawa
desturi	desturi	desturi
Dharura	Dharura	Dharura
dhoruba	dhoruba	dhoruba
diwani	diwani	diwani
dogo	dogo	dogo
Dola	Dola	Dola
dripu	dripu	dripu
Duka	Duka	Duka
dukani	duka ni	duka
dumu	dumu	dumu
duniani	dunia ni	dunia
Elfu	Elfu	Elfu
eti	eti	eti
faini	faini	faini
fani	fani	fani
fedha	fedha	fedha
figo	figo	figo
fitna	fitna	fitna
foleni	foleni	foleni
fukwe	fukwe	fukwe
gani	gani	gani
geni	geni	geni
gesi	gesi	gesi
ghafla	ghafla	ghafla
gharama	gharam a	gharam
Ghasia	Ghasia	Ghasia
haba	haba	haba
HABARI	HABARI	HABARI
hadharani	hadhar a ni	hadhar
hadi	hadi	hadi
haijaeleweka	ha i ja elew ek a	elew
haijaisha	ha i ja ish a	ish
haijajiandaa	ha i ja ji anda a	anda
haijatengamaa	ha i ja tengama a	tengama
haikunyesha	ha i ku ny esh a	ny
haikuwa	ha i kuw a	kuw
haipaswi	ha i pas w i	pas
haitoshi	ha i toshi	toshi
haizingatiwi	ha i zingati w i	zingati
hajakamatwa	ha ja kamat w a	mat
Haki	Haki	Haki
hakikuwa	ha ki kuw a	kuw
hakusaidii	ha ku saidi i	saidi
hali	hali	hali
halikadhalika	hali kadhalika	hali
halimashauri	halimashauri	halimashauri
Halmashauri	Halmashauri	Halmashauri
hao	ha o	ha
hapa	ha pa	ha
hapo	ha po	ha
HARAKA	HARAKA	HARAKA
hatima	hatim a	hatim
hatimaye	hatim a ye	hatim
Hatua	Hatua	Hatua
hatuna	ha tun a	tun
hatuwapi	ha tu wa p i	p
haujadhihirika	ha u ja dhihir ik a	dhihir
haujatangazwa	ha u ja tangaz w a	tangaz
haukutokea	ha u ku tok e a	tok
hawa	ha wa	ha
hawajaondoka	ha wa ja ondo k a	ondo
hawakuzichoma	ha wa ku zi chom a	chom
hawataisahau	ha wa ta i sahau	sahau
hawataki	ha wa tak i	tak
haya	ha ya	ha
hayana	ha ya na	ha 
hayatatangazwa	ha ya ta tangaz w a	tangaz
Hayo	Ha yo	Ha
hazijajulikana	ha zi ja ju lik an a	ju
hazionekane	ha zi on ek an e 	on
hazipitiki	ha zi pit ik i	pit
hazipo	ha zi po	po
hazitachukuliwa	ha zi ta chuku liw a	chuku
hazitaletwa	ha zi ta let w a	let
hazitarajiwi	ha zi taraji w i	taraji
haziwezi	ha zi wez i	wez
hekta	hekta	hekta
herufi	herufi	herufi
hewa	hewa	hewa
hewani	hewa ni	hewa
hicho	hi cho	hi
Hiki	Hi ki	Hi
HILI	HI LI	HI
hilo	hi lo	hi
hivi	hi vi	hi
hizi	hi zi	hi
hizo	hi zo	hi
Hospitali	Hospitali	Hospitali
hotuba	hotuba	hotuba
huadhimisha	hu adhim ish a	adhim
huambukizwa	hu ambu k iz w a	ambu
huchafuliwa	hu chafu liw a	chafu
huchukua	hu chuku a	chuku
huenda	hu end a	end
hufariki	hu fariki	fariki
hufika	hu fik a	fik
hufuatiwa	hu fuat i w a	fuat
hugusa	hu gus a	gus
huko	hu ko	hu
huku	hu ku	hu
hulazimika	hu lazim ik a	lazim
humuhumu	humu humu	humu
huo	hu o	hu
huohuo	huo huo	huo
hupata	hu pat a	pat
hupewa	hu p<e> w a	p<e>
hurikan	hurikan	hurikan
husababisha	hu sabab ish a	sabab
husika	hus ik a	hus
hutokana	hu tok an a	tok
huu	huu	huu
huvuja	hu vuj a	vuj
huweza	hu wez a	wez
huyu	hu yu	hu
Huzuni	Huzuni	Huzuni
ichukue	i chuku e	chuku
Idadi	Idadi	Idadi
ifikapo	i fik a po	fik
Ijumaa	Ijumaa	Ijumaa
ikaathiri	i ka athiri	athiri
ikaleta	i ka let a	let
ikaongeza	i ka ongez a	ongez
ikashindwa	i ka shind w a	shind
ikifanya	i ki fany a	fany
ikifanyika	i ki fany ik a	fany
ikitoa	i ki to a	to
ikitokea	i ki tok e a	tok
ikivuja	i ki vuj a	vuj
ikiwahimiza	i ki wa him iz a	him
ikiwamo	i ki wamo	wamo
ikizingilwa	i ki zingil w a	zingil
ikweta	ikweta	ikweta
ila	ila	ila
ile	i le	le
Ili	Ili	Ili
iliathirika	i li athir ik a	athir
ilichangia	i li chang i a	chang
ilielezwa	i li elez w a	elez
ilikufa	i li ku f a	f
ilikukimbia	i li ku kimbi a	kimbi
ilikumbwa	i li kumb w a	kumb
ililazimika	i li lazim ik a	lazim
iliojiri	i li o jiri	li
ilioko	i li o ko	li
iliomba	i li omb a	omb
ilionekana	i li on ek an a	on
ilipoharibu	i li po haribu	haribu
ilipotimu	i li potim u	potim
ilipozungumza	i li po zungum z a	zungum
iliruka	i li ruk a	ruk
ilishatolewa	i li sha to lew a	to
ilitoa	i li to a	to
ilitokana	i li tok an a	tok
ilivyo	i li vyo	vyo
ilivyoathirika	i li vyo athir ik a	athir
ilivyoripotiwa	i li vyo ripoti w a	ripoti
ilivyotarajiwa	i li vyo taraji w a	taraji
iliyoambatana	i li yo ambat an a	ambat
iliyoathirika	i li yo athir ik a	athir
iliyofanywa	i li yo fany w a	fany
iliyoitishwa	i li yo it ish w a	it
iliyoko	i li yo ko	li
iliyokuwa	i li yo kuw a	kuw
iliyoleta	i li yo let a	let
iliyonyesha	i li yo ny esh a	ny
iliyopelekea	i li yo pelek e a	pelek
iliyopita	i li yo pit a	pit
iliyoruhusu	i li yo ruhus u	ruhus
iliyotokana	i li yo tok an a	tok
iliyotokea	i li yo tok e a	tok
imani	imani	imani
imeadimika	i me adim ik a	adim
imeahidi	i me ahid i	ahidi
imeamua	i me amu a	amu
imeanza	i me anz a	anz
imebadilishwa	i me badil ish w a	badil
imebainika	i me bain ik a	bain
imebainisha	i me bain ish a	bain
imechafuliwa	i me chafu liw a	chafu
imedhibitisha	i me dhibit ish a	dhibit
imeeleza	i me elez a	elez
imeelezwa	i me elez w a	elez
imeendelea	i me endel e a	endele
imefikia	i me fik i a	fik
imefurika	i me fur ik a	fur
imekuja	i me kuj a	kuj
imekuwa	i me kuw a	kuw
imelikumba	i me li kumb a	kumb
imeongeza	i me ongez a	ongez
imeongezeka	i me ongez ek a	ongez
imepanda	i me pand a	pand
imepata	i me pat a	pat
imepiga	i me pig a	pig
imesabisha	i me sab ish a	sab
imesema	i me sem a	sem
imesemekana	i me sem ek an a	sem
imeshindikana	i me shind ik an a	shind
imeshuhudia	i me shuhudi a	shuhudi
imetahadharisha	i me ta hadhar ish a	hadhar
imetangaza	i me tanga z a	tangaz
imeteketea	i me teket e a	teket
imethibitika	i me thibit ik a	thibit
imetoa	i me to a	to
imetoka	i me tok a	tok
imetokana	i me tok an a	tok
imetokomeza	i me tokom ez a	tokom
Imetolewa	I me to lew a	to
imetuma	i me tum a	tum
imewahi	i me wahi	hi
imewaondoa	i me wa ondo a	ondo
imewatahadharisha	i me wa ta hadhar ish a	hadhar
imewaua	i me wa u a	u
imeweka	i me wek a	wek
imewekwa	i me wek w a	wek
inaanza	i na anz a	anz
Inadaiwa	I na dai w a	dai
inadhaniwa	i na dhani w a	dhani
inaendelea	i na endel e a	endele
inahitajika	i na hitaj ik a	hitaj
inajitahidi	i na ji tahid i	tahidi
inajukumu	i na jukum u	jukum
inakana	i na kan a	kan
inakumbwa	i na kumb w a	kumb
inaleta	i na let a	let
inaona	i na on a	on
Inaonekana	I na on ek an a	on
inapatikana	i na pat ik an a	pat
inapopambana	i na po pamban a	pamban
inasaidia	i na saidi a	saidi
inasema	in a sem a	sem
inashuhudiwa	i na shuhudi w a	shuhudi
inatokomezwa	i na tokom ez w a	tokom
inawezekana	i na wez ek an a	wez
inayoandamana	i na yo andam an a	andam
inayoanza	i na yo anz a	anz
inayojulikana	i na yo ju lik an a	ju
inayoonekana	i na yo on ek an a	on
inayoshirikisha	i na yo shirik ish a	shirik
Inayoshughulikia	I na yo shughul ik i a	shughul
inayotarajiwa	i na yo taraji w a	taraji
inayotolewa	i na yo to lew a	to
Ingawa	Ingawa	Ingawa
ingawaje	ingawa je	ingawa
Ingekuwa	Inge kuw a	kuw
ioze	i oz e	oz
ipasavyo	i pasa vyo	pasa
ipo	i po	po
ishara	ishara	ishara
isije	i si je	je
isiyokuwa	i si yo kuw a	kuw
itabidi	i ta bidi	bidi
itaendelea	i ta endel e a	endele
itakapojipanga	i ta ka po ji pang a	pang
itakavyokuwa	i ta ka vyo kuw a	kuw
itakuwa	i ta kuw a	kuw
itanyesha	i ta ny esh a	ny
itapunguza	i ta pung uz a	pung
itarejelea	i ta rej e le a	rej
itatoa	i ta to a	to
itokayo	i tok a yo	tok
itumie	i tum i e	tum
Itwayo	I twa yo	twa
Iwapo	Iwa po	po
jamaa	jamaa	jamaa
jamani	jamani	jamani
jamii	jamii	jamii
Jamuhuri	Jamuhuri	Jamuhuri
Janga	Janga	Janga
jangwa	jangwa	jangwa
Jangwani	Jangwa ni	Jangwa
jela	jela	jela
Jiji	Ji ji	ji
Jimbo	Jimbo	Jimbo
jina	jina	jina
jinsi	jinsi	jinsi
jiolojia	jiolojia	jiolojia
Jitihada	Jitihada	Jitihada
joto	joto	joto
Jua	Jua	Jua
Juhudi	Juhudi	Juhudi
Julai	Julai	Julai
juma	juma	juma
Jumla	Juml a	Juml
Jumuiya	Jumuiya	Jumuiya
Juni	Juni	Juni
kabila	kabila	bila
kabisa	kabisa	bisa
Kabla	Kabla	Kabla
kadha	kadha	dha
kadhalika	kadhalika	dhalika
kafanya	ka fany a	fany
KAHAMA	KA HAM A	HAM
kaka	kaka	ka
Kalenga	Ka leng a	leng 
kama	kama	ma
kamaliza	ka maliz a	maliz
KAMBI	KAMBI	KAMBI
Kamishna	Kamishna	Kamishna
kampeini	kampeini	mpeini
kampeni	kampeni	mpeni
kampuni	kampuni	mpuni
Kanda	Kanda	Kanda
Kansela	Kansela	Kansela
karibu	karibu	ribu
karibuni	karibu ni	ribu
Kasi	Kasi	Kasi
Kaskazini	Kaskazi ni	Kaskazi
kasoro	kasoro	soro
kata	kata	ta
katiba	katiba	tiba
katibu	katibu	tibu
katoka	ka to ka	tok
Kauli	Kauli	Kauli
Kaunti	Kaunti	Kaunti
Kavu	Kavu	Kavu
kazini	kazi ni	zi
kesho	kesho	kesho
Kesi	Kesi	Kesi
kiasi	kiasi	kiasi
kibaya	ki baya	baya
kibiashara	ki biashara	biashara
Kibinadamu	Ki binadamu	binadamu
kibinafsi	ki binafsi	binafsi
kifedha	ki fedha	fedha
kifo	kifo	kifo
kifua	kifua	kifua
kifungo	kifungo	kifungo
kifupi	ki fupi	fupi
kifusi	kifusi	kifusi
Kigogo	Ki gogo	gogo
kigoma	kigoma	Kigoma
Kihindi	Ki hindi	hindi
kijamii	ki jamii	jamii
kijijini	ki jiji ni	jiji
kijiografia	ki jiografia	jiografia
kijiolojia	ki jiolojia	jiolojia
kijulikanacho	ki ju lik a na cho	ju
kikabila	ki kabila	bila
kikali	ki kali	li
kikamilifu	ki kamili fu	mili
kikao	ki kao	o
KIKATIBA	KI KATIBA	KATIBA
kike	ki ke	ke
kikielekea	ki ki eleke a	eleke
kikiwa	ki ki wa	wa
Kikosi	Ki kosi	kosi
kikubwa	ki kubwa	kubwa
kikundi	ki kundi	kundi
Kikuu	Ki kuu	kuu
KILA	KILA	KILA
kile	ki le	le
kiliathiriwa	ki li athiri w a	athiri
kilichogunduliwa	ki li cho gundu liw a	gundu
kilichojiri	ki li cho jiri	jiri
kilichokuwa	ki li cho kuw a	kuw
Kilichomkasirisha	Ki li cho m kasir ish a	sir
kilichopelekwa	ki li cho pelek w a	pelek
kilichopewa	ki li cho p<e> w a	p<e>
kilichopo	ki li cho po	po
kilichotokana	ki li cho tok an a	tok
kilichowekwa	ki li cho wek w a	wek
kilifagia	ki li fagi a	fagi
kilifika	ki li fik a	fik
Kilifuata	Ki li fuat a	fuat
kiliharibu	ki li haribu	haribu
kilima	ki lima	ki lima
kilimo	kilimo	kilimo
kilisema	ki li sem a	sem
kilishushwa	ki li shu sh w a	shu
Kimarekani	Ki marekani	marekani
kimataifa	ki ma taifa	taifa
kimaumbile	ki ma umbil e	umbil
kimbunga	ki mbunga	mbunga
kimeathiri	ki me athiri	athiri
kimedolola	ki me dolol a	dolol
kimeendelea	ki me endele a	endele
kimeezuliwa	ki me ezu liw a	ezu
kimesababisha	ki me sabab ish a	sabab
kimeuwa	ki me uw a	uw
kinachemsha	ki na chem sh a	chem
kinachoendelea	ki na cho endel e a	endele
kinachokabiliwa	ki na cho kabili w a	kabili
kinachotakiwa	ki na cho tak i w a	tak
kinafuata	ki na fuat a	fuat
kinakuja	ki na kuj a	kuj
kinapoyafikia	ki na po ya fik i a	fik
kinasema	ki na sem a	sem
kinazidi	ki na zidi	zidi
kingine	ki ngine	ingine
Kingo	Kingo	Kingo
kinidhamu	ki nidhamu	dhamu
kipaumbele	ki pa umbel e	umbel
kipekee	ki pekee	pekee
kipo	ki po	po
Kipolisi	Ki polisi	polisi
Kipumbwi	Ki pumbwi	pumbwi
Kirusi	Ki rusi	rusi
kisa	ki sa	sa
kisambazwe	ki samba z w e	samba
kisha	k i sha	sha
kishindo	ki shindo	shindo
kisiasa	ki siasa	siasa
kisiwani	kisiwa ni	kisiwa
kisukuma	ki sukuma	sukuma
Kiswahili	Ki swahili	swahili
kitaalam	ki taalam	taalam
kitaendelea	ki ta endel e a	endele
Kitaifa	Ki taifa	taifa
kitakachosababisha	ki ta ka cho sabab ish a	sabab
kitendo	ki tend o	tend
kitisho	ki tish o	tish
Kitivo	Ki tivo	tivo
Kitovu	Ki tovu	tovu
kitropiki	ki tropiki	tropiki
kitu	ki tu	tu
kiuchumi	ki uchumi	uchumi
kiufundi	ki u fundi	fundi
kiume	ki ume	ume
Kiunga	Ki unga	unga
kiutalaam	ki u talaam	talaam
kivita	ki vita	vita
Kizayuni	Ki zayuni	zayuni
klabu	klabu	klabu
koo	koo	koo
kooni	koo ni	koo
Kopa	Kop a	Kop
kuachia	ku ach i a	ach
kuahirishwa	ku ahir ish w a	ahir
kuambukiza	ku ambu k iz a	ambu
kuandamana	ku andam an a	andam
kuandika	ku andik a	andik
kuanza	ku anz a	anz
kuanzishwa	ku anz ish w a	anz
kuathiriwa	ku athiri w a	athiri
kubadili	ku badili	badili
kuboresha	ku bor esh a	bor
KUBWA	KUBWA	KUBWA
kuchangia	ku chang i a	chang
kuchimba	ku chimb a	chimb
kuchoma	ku chom a	chom
kuchomwa	ku chom w a	chom
kuchukua	ku chuku a	chuku
kuchunga	ku chung a	chung
kuchunguza	ku chunguz a	chunguz
kudumu	ku dumu	dumu
kuelekea	ku eleke a	eleke
kuelimika	ku elim ik a	elim
kuendesha	ku end esh a	end
kuenea	ku ene a	ene
kufa	ku f a	f
kufadhili	ku fadhili	fadhili
Kufanana	Ku fan an a	fan
kufariki	ku fariki	fariki
kuficha	ku fich a	fich
Kufikia	Ku fik i a	fik
kufikisha	ku fik ish a 	fik
kufikishwa	ku fik ish w a	fik
kufuatana	ku fuat an a	fuat
kufufua	ku fufu a	fufu
kufukuzwa	ku fukuz w a	fukuz
kufumaniwa	ku fuman i w a	fuman
kufundisha	ku fund ish a	fund
kufunga	ku fung a	fung
kugawa	ku gaw a	gaw
kugeuka	ku geuk a	geuk
kugundulika	ku gundu lik a	gundu
kuhaha	ku haha	haha
kuhakikisha	ku hakik ish a	hakik
kuhamishiwa	ku hamish i w a	hamish
kuharibika	ku harib ik a	harib
kuharibiwa	ku haribi w a	haribi
kuharibu	ku haribu	haribu
kuharisha	ku har ish a	har
kuheshimiana	ku heshim i an a	heshim 
kuheshimiwa	ku heshim i wa	heshim
kuhudhuria	ku hudhur i a	hudhur
kuhusiana	ku hus i an a	hus
Kuhusu	Ku husu	husu
kuibuka	ku i buk a	buk
kuifanya	ku i fany a	fany
kuilaumu	ku i laum u	laum
kuimarika	ku imar ik a	imar
kuimarisha	ku imar ish a	imar
kuingia	ku ing i a	inga
kuinua	ku inu a	inu
kuipa	ku i p a	p
kuirejesha	ku i rej esh a	rej
kuisaidia	ku i saidi a	saidi
kuisimamia	ku i simam i a	simam
kuitumia	ku i tum i a	tum
kuja	ku ja	ja
kujaa	ku ja a	ja
kujaribu	ku jaribu	jaribu
kujenga	ku jeng a	jeng
kujengea	ku jeng e a	jeng
kujeruhi	ku jeruhi	jeruhi
kujeruhiwa	ku jeruhi w a	jeruhi
kujiandaa	ku ji anda a	anda
kujibu	ku jibu	jibu
kujiepusha	ku ji epu<sh> a	epu<sh>
kujifunga	ku ji fung a	fung
kujiimarisha	ku ji imar ish a	imar
KUJIKINGA	KU JI KING A	KING
kujisafisha	ku ji saf ish a	ji saf
kujitayarisha	ku ji tayar ish a	tayar
kujizuia	ku ji zui a	zui
kujua	ku ju a	ju
kukaa	ku ka a	ka
Kukabiliana	Ku kabili an a	kabili
kukadiriwa	ku kadiri w a	kadiri
kukagua	ku kagu a	kagu
kukakabiliana	ku ka kabili an a	kabili
kukamatwa	ku kamat w a	kamat
kukarabati	ku karabati	karabati
kukatisha	ku kat ish a	kata
kukidhi	ku kidhi	kidhi
kukimbilia	ku kimbi li a	kimbi
kukiwa	ku ki wa	ki
kukopesha	ku kop esh a	kop
kukosa	ku kos a	kos
kukosoa	ku kos o a	kos
kukumbwa	ku kumb w a	kumb
KUKUMBWA	KU KUMB W A	KUMB
kukwama	ku kwam a	kwam
kulala	ku lal a	lal
kulaumiwa	ku laum i w a	laum
kulazimika	ku lazim ik a	lazim
kulegea	ku leg e a	leg
kulia	ku li a	li
kuliita	ku li it a	it
kuliko	kuliko	kuliko
kulima	ku lim a	lim
kulinda	ku lind a	lind
kulinga	ku ling a	ling
Kulingana	Ku ling an a	linga
kulipuka	ku li puk a	puk
kulitokea	ku li tok e a	tok
kumalizika	ku maliz ik a	maliz
kumchukua	ku m chuku a	chuku
kumchukulia	ku m chuku li a	chuku
kumekua	ku me ku a	ku
kumesababisha	ku me sabab ish a	sabab
kumsaidia	ku m saidi a	saidi
kumshukuru	ku m shukuru	shukuru
kumsubiria	ku m subiri a	subiri
kumudu	ku mudu	mudu
kumuongezea	ku mu ongez e a	ongez
kumwomba	ku mw omb a	omb
kunapotokea	ku na po tok e a	tok
kung’oa	ku ng’o a	ng’o
kung’olewa	ku ng’o lew a	ng’o
kungojea	ku ngoj e a	ngoj
kuniacha	ku ni ach a	ach
kununua	ku nunu a	nunu
kununulia	ku nunu li a	nunu
kunyesha	ku ny esh a	ny
kunywa	ku nyw a	nyw
kuomba	ku omb a	omb
kuona	ku on a	on
kuondoa	ku ondo a	ondo
kuonekana	ku on ek an a	on
kuongea	ku onge a	onge
kuosha	ku osh a	osh
kupakiwa	ku pak i w a	pak
kupanga	ku pang a	pang
kupata	ku pat a	pat
kupelekwa	ku pelek w a	pelek
kupewa	ku p<e> w a	p<e>
kupiga	ku pig a	pig
kupigana	ku pig an a	pig
kupigiwa	ku pig i w a	pig
kupika	ku pik a	pik
kupinduka	ku pindu k a	pindu
kupisha	ku pish a	pish
kupitia	ku pit i a	pit
kupokea	ku poke a	poke
kupotea	ku pot e a	pot
kupotelewa	ku pot e lew a	pot
kupoteza	ku pot ez a	pot
kurahisisha	ku rahis ish a	rahis
kuridhisha	ku ridhish a	ridhish
kurudishwa	ku rud ish w a	rud
kuruka	ku ruk a	ruk
kusafiri	ku safiri	safiri
kusafisha	ku saf ish a	saf
kusaka	ku sak a	sak
kusalia	ku sal i a	sal
kusambaa	ku samba a	samba
kusambaratika	ku sambarati k a	sambarati
kusambaza	ku samba z a	samba
kusema	ku sem a	sem
kushangaza	ku shanga z a	shanga
kushika	ku shik a	shik
kushughilikia	ku shughil ik i a	shughil
kushuhudia	ku shuhudi a	shuhudi
kusimamia	ku simam i a	simam
kusombwa	ku somb w a	somb
kusubiri	ku subiri	subiri
kusukuma	ku sukum a	sukum
kuta	kuta	kuta
kutabasamu	ku tabasamu	tabasamu
kutabiriwa	ku tabiri w a	tabiri
kutafuta	ku ta fut a	ta fut
kutambaa	ku tamba a	tamba
kutapika	ku tap ik a	tap
kutathmini	ku tathmini	tathmini
kutatiza	ku tatiz a	tatiz
kutatokea	ku ta tok e a	tok
kuteketeza	ku teket ez a	teket
kuthibitishwa	ku thibit ish w a	thibit
kutii	ku tii	tii
kutoa	ku to a	to
kutoka	ku tok a	tok
KUTOKANA	KU TOK AN A	TOK
kutokea	ku tok e a	tok
kutokulegeza	ku to ku leg ez a	leg
kutokwa	ku tok w a	tok
kutolewa	ku to lew a	to
kutopitika	ku to pit ik a	pit
kutosha	ku tosh a	tosh
kutotambulika	ku to tambu lik a	tambu
kutuliza	ku tul iz a	tul
kutumbukiza	ku tumbuk iz a	tumbuk
kutumika	ku tum ik a	tum
kutupa	ku tup a	tup
kuua	ku ua	ua
kuunga	ku ung a	ung
kuungana	ku ung an a	ung
kuuwa	ku uw a	uw
kuuza	ku uz a	uz
kuvamiwa	ku vami w a	vami
kuvirusha	ku vi rush a	rush
kuvuja	ku vuj a	vuj
kuvunja	ku vunj a	vunj
Kuwa	Kuwa	Kuwa
kuwaacha	ku wa ach a	ach
kuwadhibiti	ku wa dhibiti	dhibiti
kuwafuatilia	ku wa fuat i li a	fuat
kuwahamisha	ku wa ham ish a	ham
kuwajeruhi	ku wa jeruhi	jeruhi
kuwakaribisha	ku wa karib ish a	karib
kuwalipa	ku wa lip a	lip
kuwaokoa	ku wa oko a	oko
kuwaondoa	ku wa ondo a	ondo
kuwaondosha	ku wa ondo sh a	ondo
kuwapeleka	ku wa pelek a	pelek
kuwapelekea	ku wa pelek e a	pelek
kuwasaidia	ku wa saidi a	saidi
kuwashauri	ku wa shauri	shauri
kuwasili	ku wasil i	wasili
kuwatafutia	ku wa tafut i a	tafut
kuwataka	ku wa tak a	tak
kuwavusha	ku wa vu sh a	vu
kuweka	ku wek a	wek
kuwepo	ku we po	po
kuwezesha	ku wez esh a	wez
kuyachafua	ku ya chafu a	chafu
kuyafikia	ku ya fik i a	fik
kuyahama	ku ya ham a	ham
kuyapiga	ku ya pig a	pig
kuzalisha	ku za lish a	za
kuziba	ku zib a	zib
kuzidi	ku zidi	zidi
kuzikumba	ku zi kumb a	kumb
kuzima	ku zim a	zim
kuzingatia	ku zingati a	zingati
kuzingirwa	ku zingir wa	zingir
kuzisaidia	ku zi saidi a	saidi
kuzuiliwa	ku zui liw a	zui
kuzuka	ku zuk a	zuk
kuzuwia	ku zuwi a	zuwi
KWA	KWA	KWA
kwake	kw a ke	kw 
kwamba	kwamba	kwamba
kwangu	kw angu	angu
kwanza	kwanza	kwanza
kwao	kwao	kwao
kwasababu	kwa sababu	sababu
Kwenda	Kw end a	end
kwenye	kw enye	enye
Kwesi	Kwesi	Kwesi
la	la	la
laki	laki	laki
lasimamishwa	la simam ish w a	simam
latangazwa	la tangaz w a	tangaz
lazikumba	la zi kumb a	kumb
lengo	leng o	leng
lenye	l enye	enye
letu	l etu	etu
likikumbwa	li ki kumb w a	kumb
likitoa	li ki to a	to
lile	li le	le
liliahidi	li li ahidi	ahidi
lilieleza	li li elez a	elez
lilielezea	li li elez e a	elez
lilifunguliwa	li li fungu liw a	fungu
lilihisiwa	li li hisi w a	hisi
lilikanusha	li li kanu sh a	lkanu
lililoathirika	li li lo athir ik a	athir
lililoathiriwa	li li lo athiri w a	athiri
lililoikumba	li li lo i kumb a	kumb
lililokumba	li li lo kumb a	kumb
lililolikumba	li li lo li kumb a	kumb
lililopita	li li lo pit a	pit
lililotokea	li li lo tok e a	tok
liliongeza	li li ongez a	ongez
lilipitisha	li li pit ish a	pit
lilipokamilika	li li po kamil ik a	kamil
lilipopiga	li li po pig a	pig
liliripotiwa	li li ripoti w a	ripoti
lilisababisha	li li sabab ish a	sabab
lilisitukiza	li li situk iz a	situk
lilitikisa	li li tikis a	tikis
limefunga	li me fung a	fung
limehudhuriwa	li me hudhuri w a	hudhuri
limekaukiwa	li me kauki w a	kauki
limekiri	li me kiri	kiri
limenusurika	li me nusur ik a	nusur
limepata	li me pat a	pat
limepeleka	li me pelek a	pelek
limepokea	li me poke a	poke
limeripoti	li me ripoti	ripoti
limesababisha	li me sabab ish a	sabab
limesema	li me sem a	sem
limetahadharisha	li me ta hadhar ish a	hadhar
limetikisa	li me tikis a	tikis
linakumbwa	li na kumb w a	kumb
linalenga	li na leng a	leng
linalotoa	li na lo to a	to
linalouza	li na lo uz a	uz
linalovumilia	li na lo vumil i a	vumil
linalozingira	li na lo zingir a	zingir
linamfanyia	li na m fany i a	fany
linamilikiwa	li na miliki w a	miliki
linapambana	li na pamban a	pamban
linapita	li na pit a	pit
linasafirisha	li na safir ish a	safir
lingine	li ngine	ngine
lipo	li po	po
lishe	lishe	lishe
lisilo	li si lo	lo
lisitukute	li si tu kut e	kut
litaitisha	li ta i tish a	tish
litakalo	li ta ka lo	ka
lote	l ote	ote
lugha	lugha	lugha
Lyassa	Lyassa	Lyassa
maadili	ma adili	adili
maafa	ma afa	afa
Maafisa	Ma afisa	afisa
maambukizo	ma ambu k iz o	ambu
Maamuzi	Ma amu z i	amu
mabadiliko	ma badili ko	badili
mabanda	ma banda	banda
mabati	ma bati	bati
mabaya	ma baya	baya
mabomba	ma bomba	bomba
mabonde	ma bonde	bonde
mabondeni	ma bonde ni	bonde
machafu	ma chafu	chafu
machozi	ma chozi	chozi
madai	ma dai	dai
madaktari	ma daktari	daktari
madhubuti	madhubuti	madhubuti
Madini	Ma dini	dini
madirisha	ma dirisha	dirisha
madogo	ma dogo	dogo
Maduka	Ma duka	duka
madukani	ma duka ni	duka
Maelezo	Ma elez o	elez
maelfu	ma elfu	elfu
Maendeleo	Ma endele o	endele
Maeneo	Ma eneo	eneo
Mafuriko	Ma fur ik o	fur
Magari	Ma gari	gari
magharibi	magharibi	magharibi
maghorofa	ma ghorofa	ghorofa
Magonjwa	Ma gonjwa	gonjwa
magunia	ma gunia	gunia
Mahakama	Ma hakama	hakama
mahali	mahali	mahali
mahitaji	ma hitaji	hitaj
mahojiano	ma hoji a no	hoji 
mahususi	ma hususi	hususi
maisha	maisha	maisha
maiti	maiti	maiti
Majanga	Ma janga	janga
majeraha	ma jeraha	jeraha
MAJERUHI	MA JERUHI	JERUHI
majiji	ma jiji	jiji
majimaji	maji maji	maji
majimbo	ma jimbo	jimbo
Majina	Ma jina	jina
majivu	ma jivu	jivu
majuma	ma juma	juma
makadirio	ma kadiri o	kadiri
makali	ma kali	kali
makambi	ma kambi	kambi
Makampuni	Ma kampuni	kampuni
makazi	ma kazi	kazi
makontena	ma kontena	kontena
Makumi	Ma kumi	kumi
makundi	ma kundi	kundi
Makuti	Ma kuti	kuti
makwao	ma kwa o	kwa
mama	mama	mama
mamake	mama ke	mama
Mambo	M ambo	ambo
mamia	ma mia	mia
mamilioni	ma milioni	milioni
Mamlaka	Mamlaka	Mamlaka
manane	ma nane	nane
maneno	ma neno	neno
Manispaa	Manispaa	Manispaa
manusura	ma nusur a	nusur
Maofisa	Ma ofisa	ofisa
maongezi	ma ongez i	ongez
Maoni	Ma oni	oni
mapaa	ma paa	paa
Mapema	Mapema	Mapema
mapipa	ma pipa	pipa
Maporomoko	Ma poromok o	poromok
mapumziko	ma pumz ik o	pumz
mapya	mapya	mapya
Mara	Mara	Mara
maradhi	maradhi	maradhi
maradufu	mara dufu	mara
marefu	ma refu	refu
marehemu	marehemu	marehemu
maripota	ma ripota	ripota
marufuku	marufuku	marufuku
Masabubu	Ma sabubu	sabubu
mashahidi	ma shahidi	shahidi
mashamba	ma shamba	shamba
Mashariki	Mashariki	Mashariki
masharti	ma sharti	sharti
Mashirika	Ma shirika	shirika
mashua	ma shua	shua
mashuhuri	mashuhuri	mashuhuri
mashuleni	ma shule ni	shule
Masika	Masika	Masika
masikio	ma siki o	siki
maskini	maskini	maskini
masomo	ma somo	somo
matatizo	ma tati zo	tati
matatu	ma tatu	tatu
matawi	ma tawi	tawi
matayarisho	ma tayar ish o	tayar
Mateka	Ma tek a	tek
Matetemeko	Ma tetem ek o	tetem
matibabu	ma tibabu	tibabu
matope	ma tope	tope
matumaini	ma tumai ni	tumai
matumizi	matumizi	matumizi
matunda	ma tunda	tunda
maumivu	ma umi vu	umi vu
mavazi	ma vazi	vazi
mazao	ma za o	za
mazishi	mazishi	mazishi
maziwa	ma ziwa	ziwa
mbingu	mbingu	mbingu
mbuga	mbuga	mbuga
Mbunge	M bunge	bunge
mbwa	mbwa	mbwa
mchanga	m changa	changa
mchango	m chango	chango
mchele	m chele	chele
Mchumi	M chumi	chumi
meli	meli	meli
Meneja	Meneja	Meneja
meza	meza	meza
Mfalme	M falme	falme
Mfano	M fano	fano
mfululizo	m fululizo	fululizo
mfupi	m fupi	fupi
Mganga	M ganga	ganga
mgodi	m godi	godi
mgonjwa	m gonjwa	gonjwa
mhandisi	m handisi	handisi
mia	mia	mia
Miaka	Mi aka	aka
miembe	mi embe	embe
mienendo	mi enend o	enend
miezi	mi ezi	ezi
mifano	mi fano	fano
mifuko	mi fuko	fuko
migodi	mi godi	godi
miguu	mi guu	guu
miili	mi ili	ili
Miji	Mi ji	ji
mikali	mi kali	li
mikoa	mi koa	koa
Mikofu	Mi kofu	kofu
mikononi	mi kono ni	kono
mikurupuko	mi kurupu ko	kurupu
mikutano	mi kuta no	kuta
milima	mi lima	lima
milipuko	mi li puko	puko
millioni	millioni	millioni
Mimi	Mimi	Mimi
minajili	minajili	minajili
mingineyo	mi ngine yo	ngine
minne	mi nne	nne
mipakani	mi paka ni	paka
mipango	mi pang o	pang
Misaada	Mi saada	saada
misheni	misheni	misheni
misimamo	mi simam o	simam
misimu	mi simu	simu
MISITU	MI SITU	SITU
mitaa	mi taa	taa
mitaani	mi taa ni	taa
mitambo	mi tamb o	tamb
mitandao	mi tanda o	tanda
mitano	mi tano	tano
mitaro	mi taro	taro
miteremko	mi teremk o	teremk
miti	mi ti	ti
mito	mi to	to
mitumbwi	mi tumbwi	tumbwi
miundo	mi und o	und
miundombinu	mi und o mbinu	und
mizoga	mi zoga	zoga
Mjini	M ji ni	ji
mkasa	m kasa	sa
Mkazi	M kazi	kazi
Mkinga	M kinga	kinga
mkoa	m koa	koa
Mkoani	M koa ni	koa
mkongwe	m kongwe	kongwe
mkulima	m ku lima	lima
Mkurugenzi	M kurugenzi	kurugenzi
Mkutano	M kutano	kutano
mlima	m lima	lima
Mlipuko	M lipuk o	lipuk
Mmoja	M moja	moja
mnachokiamini	m na cho ki amini	amini
Mnamo	Mnamo	Mnamo
mnamo	m namo	namo
Mojawapo	Moja wa po	Mojapo
mosi	mosi	mosi
MOTO	M OTO	OTO
Mpaka	M paka	paka
Mpunga	M punga	punga
MPYA	M PYA	PYA
mraba	m raba	raba
mratibu	m ratibu	ratibu
mrefu	m refu	refu
Msaidizi	M saidi zi	saidi
msalaba	m salaba	salaba
mshauri	m shauri	shauri
msiba	m siba	siba
MSIMU	M SIMU	SIMU
Msingi	M singi	singi
msiwe	m si we	we
Mstaafu	M staafu	staafu
Msumbiji	Msumbiji	Msumbiji
Mtaalam	M taalam	taalam
Mtailandi	M tailandi	tailandi
Mtama	Mtama	Mtama
Mtanzania	M tanzania	tanzania
MTAWALA	M TAWALA	TAWALA
Mteja	M teja	teja
mtendaji	m tend aji	tend
mtikisiko	m tikis ik o	tikis
mtoto	m toto	toto
Mtu	M tu	tu
Mtumie	M tum i e	tum
Mtuwa	M tuwa	tuwa
muathirika	mu athir ik a	athir
mumuunge	mu mu unge	unge
muziki	muziki	muziki
mvua	mvua	mvua
mvutano	m vuta no	vuta 
mwakani	m w aka ni	aka
mwakilishi	mwa kilishi	kilishi
mwananchi	m wana nchi	wana
Mwanaume	M wanaume	wanaume
mwandishi	mw andi<sh> i	andi<sh>
Mwandishi	Mw andi<sh> i	andi<sh>
mwangalifu	mw a ngali fu	ngali
mwao	m wa o	wa
Mwekundu	Mw ekundu	ekundu
Mwelekeo	Mw eleke o 	eleke
mwenendo	mw enend o	enend
mwenyewe	mw enyewe	enyewe
mwezi	mw ezi	ezi
mwilini	mwili ni	mwili
mwingi	mw ingi	ingi
mwingine	mw ingine	ingine
mwisho	mw ish o	ish
mwishoni	mw ish o ni	ish
mwito	mw ito	ito
mzozo	m zozo	zozo
Mzunguko	M zunguk o	zunguk
mzunguko	m zunguk o	zunguk
mzuri	m zuri	zuri
na	na	na
nacho	na cho	cho
Nadhani	Na dhan i	dhan
nafasi	nafasi	nafasi
nafikiri	na fikir i	fikir
nakutoa	na ku to a	to
nakwenda	na kw end a	end
namna	namna	namna
nane	nane	nane
nanyi	na nyi	nyi
nao	na o	o
Nashauri	Na shauri	shauri
nasimamia	na simam i a	simam
Nawaomba	Na wa omb a	omb
naye	na ye	ye
Nchi	Nchi	Nchi
Nchini	Nchi ni	Nchi
ndefu	nd efu	efu
Ndege	N dege	dege
ndilo	ndi lo	lo
ndio	ndi o	o
ndivyo	ndi vyo	vyo
ndiyo	ndi yo	yo
ndoa	ndoa	ndoa
ndugu	ndugu	ndugu
ngamia	ngamia	ngamia
ngazi	ngazi	ngazi
Ngoma	Ngoma	Ngoma
ngumu	ngumu	ngumu
ni	ni	ni
nia	ni a	a
nichukue	ni chuku e	chuku
nilichukua	ni li chuku a	chuku
nilikuwa	ni li kuw a	kuw
nilipata	ni li pat a	pat
niliposikia	ni li po siki a	siki
nilisema	ni li sem a	sem
nilisikia	ni li siki a	siki
Nilitaka	Ni li tak a	tak
Nilitamani	Ni li tama ni	tama
Nimepigana	Ni me pig an a	pig
Nimepigania	Ni me pig an i a	pig
Nimepoteza	Ni me pot ez a	pot
nimetoka	ni me tok a	tok
ninachokiamini	ni na cho ki amini	amini
NINAWAOMBEA	NI NA WA OMB E A	OMB
ninyi	ninyi	nyi
nisifanye	ni si fany e	fany
nitaiomba	ni ta i omb a	omb
Nitasema	Ni ta sem a	sem
njaa	njaa	njaa
njama	njama	njama
nje	nje	nje
njia	njia	njia
njiani	njia ni	njia
Nusu	Nusu	Nusu
nyasi	nyasi	nyasi
nyeupe	ny eupe	eupe
nyingi	ny ingi	ingi
nyuklia	nyuklia	nyuklia
nyuma	ny uma	uma
nyusi	ny usi	usi
nyuzi	ny uzi	uzi
nzima	n zima	zima
nzuri	n zuri	zuri
ofisi	ofisi	ofisi
Oktoba	Oktoba	Oktoba
Ongezeko	Ongez ek o	Ongez
onyo	onyo	onyo
orodha	orodha	orodha
pabaya	pa baya	baya
pale	pa le	le
pamba	pamb a	pamb
pamoja	pamoja	pamoja
pande	pande	pande
Parasitolijia	Parasitolijia	Parasitolijia
Pembe	Pembe	Pembe
penye	p enye	enye
Pesa	Pesa	Pesa
petroli	petroli	petroli
picha	picha	picha
pichani	picha ni	picha
pili	pili	pili
pole	pole	pole
POLENI	POLE NI	POLE
Posta	Posta	Posta
pwani	pwani	pwani
rais	rais	rais
rambirambi	rambi rambi	rambi
Rasi	Rasi	Rasi
rasmi	rasmi	rasmi
redio	redio	redio
ripoti	ripoti	ripoti
riziki	riziki	riziki
robo	robo	robo
rudi	rudi	rudi
Rufaa	Rufaa	Rufaa
runinga	runinga	runinga
saa	saa	saa
safari	safari	safari
sakafu	sakafu	sakafu
salama	salama	salama
samaki	samaki	samaki
Same	Same	Same
SANA	SANA	SANA
Sasa	Sasa	Sasa
satelaiti	satelaiti	satelaiti
Sauti	Sauti	Sauti
sawa	sawa	sawa
Sehemu	Sehemu	Sehemu
sekta	sekta	sekta
sembuse	sembuse	sembuse
sentigredi	sentigredi	sentigredi
Sera	Sera	Sera
Shaka	Shaka	Shaka
shambani	shamba ni	shamba
Shambulio	Shambuli o	Shambuli
shehena	shehena	shehena
sheria	sheria	sheria
Shimoni	Shimo ni	Shimo
Shirika	Shirika	Shirika
shule	shule	shule
shuleni	shule ni	shule
si	si	si
sigara	sigara	sigara
sijui	si ju i	ju
Sikiliza	Siki li z a	Siki
Siku	Siku	Siku
siku	siku	siku
SILAHA	SILAHA	SILAHA
simamieni	simam i en i	simam
simiyu	simiyu	simiyu
simu	simu	simu
sina	si na	na
sio	si o	si
sita	sita	sita
sitini	sitini	sitini
sivyo	si vyo	vyo
Soko	Soko	Soko
sokoni	soko ni	soko
SOMA	SOM A	SOM
Taarifa	Taarifa	Taarifa
taasisi	taasisi	taasisi
Taassisi	Taassisi	Taassisi
taathira	taathira	taathira
TAIFA	TAIFA	TAIFA
tajiri	tajiri	tajiri
taka	taka	taka
takriban	takriban	takriban
Takwimu	Takwimu	Takwimu
tamaa	tamaa	tamaa
tamaduni	tamaduni	tamaduni
tambarare	tambarare	tambarare
TANGAZO	TANG A ZO	TANG
tani	tani	tani
tarafa	tarafa	tarafa
Tarafani	Tarafa ni	Tarafa
tathmini	tathmini	tathmini
tatizo	tatiz o	tatiz
tatu	tatu	tatu
Tawala	Tawala	Tawala
Tawi	Tawi	Tawi
tegemeo	tegem e o	tegem
televisheni	televisheni	televisheni
Tenga	Tenga	Tenga
tete	tete	tete
thamani	thamani	thamani
themanini	themanini	themanini
tiba	tiba	tiba
Ticino	Ticino	Ticino
timu	timu	timu
tisa	tisa	tisa
TISHIO	TISH IO	TISH
tofauti	tofauti	tofauti
TOKA	TOK A	TOK
tu	tu	tu
tuendelee	tu endele e	endele
tufani	tufani	tufani
Tuhamasishane	Tu hamas ish an e	hamas
tuitulize	tu i tuli ze	tuli
tukawatembelea	tu ka wa tembele a	tembele
Tukio	Tukio	Tukio
tuliingia	tu li ingi a	ingi
tuliona	tu li on a	on
tumekabili	tu me kabili	kabili
tumekitoa	tu me ki to a	to
tumeona	tu me on a	on
tumetuma	tu me tum a	tum
tumewasiliana	tu me wasili an a	wasilia
tumeweka	tu me wek a	wek
Tuna	Tu na	na
tunalazimika	tu na lazim ik a	lazim
Tunaomba	Tu na omb a	omb
tunapewa	tu na p<e> w a	p<e>
tunashukuru	tu na shukuru	shukuru
Tunasikitikia	Tu na sikitiki a	sikitiki
Tunatazamia	Tu na tazam i a	tazama
tutaendelea	tu ta endele a	endele
tutawaletea	tu ta wa let e a 	let
tutulie	tu tuli e	tuli
uadilifu	u adili fu	adili
uangalifu	u angali fu	angali
uangalizi	u angali zi	angali
ubakaji	u baka ji	baka ji
uchache	u chache	chache
uchafuzi	u chafu zi	chafu
uchaguzi	u chagu zi	chagu
Uchambuzi	U chambu zi	chambu
Ufa	U fa	fa
Ufaransa	U faransa	faransa
Ufilipino	U filipino	filipino
ufupi	u fupi	fupi
ugonjwa	u gonjwa	gonjwa
ugumu	u gumu	gumu
uhamasishaji	u hamasish aji	hamasish
uharibifu	u harib i fu	harib
Uhispania	U hispania	hispania
Uholanzi	U holanzi	holanzi
uhuru	u huru	huru
uingereza	u ingereza	ingereza
ujao	u ja o	ja
ujasiri	u jasiri	jasiri
ujue	u ju e	ju
Ukarabati	U karabati	karabati
ukasambaa	u ka samba a	samba
Ukatili	U katili	katili
uko	u ko	ko
ukosefu	u kose fu	kose
ukubwa	u kubwa	kubwa
ukwepaji	u kwepa ji	kwepa
ulianguka	u li anguk a	anguk
ulifanyika	u li fany ik a	fany
ulijitokeza	u li ji tok ez a	tok
ulilenga	u li leng a	leng
ulimwengu	u limwengu	limwengu
ulimwenguni	u limwengu ni	limwengu
ulioathiri	u li o athiri	athiri
uliodumu	u li o dumu	dumu
uliofanywa	u li o fany w a	fany
ulioikumba	u li o i kumb a	kumb
ulioko	u li o ko	ko
ulionesha	u li on esh a	on
uliopangwa	u li o pang w a	pang
uliopita	u li o pit a	pit
uliopo	u li o po	po
ulipuke	u lipuk e	lipuk
uliripoti	u li ripoti	ripoti
uliripotiwa	u li ripoti w a	ripoti
ulisambaa	u li samba a	samba
ulisema	u li sem a	sem
ulishuhudiwa	u li shuhudi w a	shuhudi
ulitangaza	u li tangaz a	tangaz
ulivunja	u li vunj a	vunj
Umakini	U makini	makini
umaskini	u maskini	maskini
umati	umati	umati
umbali	u mbali	mbali
umeahidi	u me ahidi	ahidi
umeenda	u me end a	end
umeibuka	u me ibu k a	ibu k
umekauka	u me kauk a	kauk
umeme	umeme	umeme
umepiga	u me pig a	pig
umesababishwa	u me sabab ish w a	sabab
umesema	u me sem a	sem
umeshaanza	u me sha anz a	anz
umeteketeza	u me teket ez a	teket
umetokea	u me tok e a	tok
umewaua	u me wa u a	u
umezikumba	u me zi kumb a	kumb
Umoja	U moja	moja
umri	umri	umri
umwagiliaji	u mwagi li aji	mwagi
unaambukiza	u na ambu k iz a	ambu
unaathiri	u na athiri	athiri
unaendelea	u na endele a	endele
unahitaji	u na hitaji	hitaji
unaijibu	u na i jibu	jibu
UNAINGIA	U NA INGI A	INGI
unajumlisha	u na juml ish a	jumla
unakabiliwa	u na kabili w a	kabili
unakadiria	u na kadiri a	kadiri
unamalizika	u na maliz ik a	maliz
unaoambukizwa	u na o ambu k iz w a	ambu
unaoendelea	u na o endel e a	endele
unaongezeka	u na ongez ek a	ongez
unaosifika	u na o sif ik a	sif
unashamiri	u na shamiri	shamiri
unasikia	u na siki a	siki
unasubiri	u na subiri	subiri
unatoa	u na to a	to
unavyosonga	u na vyo song a	song
unaweza	u na wez a	wez
unazusha	u na zush a	zush
uokozi	u oko zi	oko
uone	u on e	on
upembe	u pembe	pembe
Upepo	U pepo	pepo
upi	u pi	pi
upigaji	u piga ji	pig
upo	u po	po
upokeaji	u pokea ji	pokea
urahisi	u rahisi	rahisi
urais	u rais	rais
Uratibu	U ratibu	ratibu
usafi	u safi	safi
Usahihi	U sahihi	sahihi
usalama	u salama	salama
ushindi	u shindi	shindi
usiku	u siku	siku
uso	uso	uso
Ustawi	U stawi	stawi
utabiri	u tabiri	tabiri
utadhibitiwa	u ta dhibiti w a	dhibiti
Utafiti	U tafiti	tafiti
utakaotolewa	u ta ka o to lew a	to
utalii	u talii	talii
utapia	u tap i a	tap
utapiamlo	u tapia mlo	tapia
utaratibu	u taratibu	taratibu
utasimama	u ta simam a	simam
utatanishi	u tata ni shi	tata
utawala	u tawala	tawala
utawaona	u ta wa on a	taon
Utawasaidia	U ta wa saidi a	saidi
utengamano	u tengama no	tengama
utoaji	u to aji	to
Uturuki	U turuki	turuki
uvamizi	u vami zi	vami
uvuvi	u vu vi	vu
uwanja	u wanja	wanja
uwepo	u we po	po
Uwezo	U wez o	wez
uzoefu	u zoe fu	zoe
uzuke	u zuk e	zuk
viashiria	vi ashiri a	ashiri
viazi	vi azi	azi
vibaya	vi baya	baya
vichaka	vi chaka	chaka
vidimbwi	vi dimbwi	dimbwi
Vifaa	Vi faa	faa
vifo	vi fo	fo
vifupi	vi fupi	fupi
Vijana	Vi jana	jana
vikigombea	vi ki gombe a	gombe
vikipuliza	vi ki puliz a	puliz
vikiua	vi ki u a	u
viko	vi ko	ko
vikongwe	vi kongwe	kongwe
vikosi	vi kosi	kosi
vikundi	vi kundi	kundi
vile	v ile	ile
vilianza	vi li anz a	anz
vilifika	vi li fik a	fik
vilifikia	vi li fik i a	fik
viligundulika	vi li gundu lik a	gundu
vilipitia	vi li pit i a	pit
vilisombwa	vi li somb wa	somb
viliua	vi li u a	u
vilivyo	vi li vyo	vyo
vilivyoathiriwa	vi li vyo athiri w a	athiri
vilivyochafuliwa	vi li vyo chafu liw a	chafu
vilivyoko	vi li vyo ko	ko
vilivyopo	vi li vyo po	po
Vimbunga	Vi mbunga	mbunga
vimechangia	vi me chang i a	chang
vimeendelea	vi me endel e a	endele
vimeripotiwa	vi me ripoti w a	ripoti
vinafanyika	vi na fany ik a	fany
vinahitajika	vi na hitaj ik a	hitaj
vinahusiana	vi na hus i an a	hus
vinakosa	vi na kos a	kos
vinatokea	vi na tok e a	tok
vinavyotokana	vi na vyo tok an a	tok
vinavyozunguka	vi na vyo zunguk a	zunguk
vingine	vi ngine	ngine
vinu	vi nu	nu
viongozi	vi ongo zi	ongo
vipi	vi pi	pi
vipimo	vi pimo	pimo
virefu	vi refu	refu
visiwa	vi siwa	siwa
vitamu	vi tamu	tamu
vitasambazwa	vi ta samba z w a	samba
vitendo	vi tend o	tend
vitu	vi tu	tu
vituo	vi tuo	tuo
viwango	vi wango	wango
Vizuizi	Vi zui zi	zui
vizuri	vi zuri	zuri
vurugu	vurugu	vurugu
VYA	VYA	VYA
VYAADIMIKA	VYA ADIM IK A	ADIM
vyakula	vy akul a	akul
vyandarua	vy andarua	andarua
vyanzo	vy anz o	anz
vyao	vy ao	vy ao
vyema	vy ema	ema
VYOO	VY OO	OO
vyote	vy ote	ote
wa	wa	wa
Waandishi	Wa andi<sh> i	andi<sh>
waasi	wa asi	asi
waathiri	wa athiri	athiri
waathirika	wa athir ik a	athir
wabainika	wa bain ik a	bain
wachimba	wa chimb a	chimb
Wachimbe	Wa chimb e	chimb
Wachungaji	Wa chung aji	chung
wachuuzi	wa chuuz i	chuuz
wadau	wa dau	dau
wadogo	wa dogo	dogo
waethiopia	wa ethiopia	ethiopia
wafa	wa fa	fa
wafanyabiashara	wa fanya biashara	fanya
wafanyakazi	wa fanya kazi	fanya
wafanyikia	wa fany ik i a	fanya
wafariki	wa fariki	fariki
WAFIWA	WA FIWA	FIWA
wafu	wa fu	fu
Wafugaji	Wa fug aji	fug
wafurushwa	wa furush w a	furush
wahaha	wa haha	haha
wahalifu	wa halifu	halifu
wahame	wa ham e	ham
wahanga	wa hanga	hanga
Wahudumu	Wa hudumu	hudumu
waimarishe	wa imar ish e	imar
wajibu	wa jibu	jibu
Wakaazi	Wa kaa zi	kaa
Wakala	Wa ka la	ka
Wakati	Wa kati	ti
Wakazi	Wa ka z i	ka
Wake	Wa ke	ke
wakenya	wa kenya	kenya
wakielekea	wa ki eleke a	eleke
wakieleza	wa ki elez a	elez
wakigombania	wa ki gomb an i a	gomb
wakiishi	wa ki ishi	ishi
wakikabiliana	wa ki kabili an a	kabili
wakikerwa	wa ki ker w a	ker
wakikimbia	wa ki ki mbi a	mbi
wakikosekana	wa ki kos ek an a	kos
wakilalamika	wa ki lalam ik a	lalam
wakilalamikia	wa ki lalam ik i a	lalam
wakimbizi	wa kimb iz i	kimb
wakimkabidhi	wa ki m kabidhi	kabidhi
waking'ang'ania	wa ki ng'ang'an i a	ng'ang'ana
wakiomba	wa ki omb a	omb
wakiongea	wa ki onge a	onge
wakipatiwa	wa ki pa ti wa	pa
wakisaidiwa	wa ki saidi w a	saidi
wakisaka	wa ki sak a	sak
wakishiriki	wa ki shiriki	shiriki
wakishusha	wa ki shu<sh> a	shu<sh>
wakisubiri	wa ki subiri	subiri
wakitibiwa	wa ki tibi w a	tibi
wakitokea	wa ki tok e a	tok
wakiuawa	wa ki ua w a	ua
wakiugua	wa ki ugu a	ugu
wakiwapungia	wa ki wa pung i a	pung
wakiwatafuta	wa ki wa ta fut a	fut
wakubwa	wa kubwa	kubwa
Wakulima	Wa kulima	kulima
wakulima	wa kulima	kulima
wakuu	wa kuu	kuu
wala	wala	la
Wale	Wa le	le
waliamrishwa	wa li amr ish w a	amr
walianza	wa li anz a	anz
walibaini	wa li baini	baini
waliilaumu	wa li i laumu	laumu
walijieleza	wa li ji elez a	elez
walijitokeza	wa li ji tok ez a	tok
walikimbia	wa li kimbi a	kimbi
walikitegemea	wa li ki tegem e a	tegem
waliko	wa li ko	ko
walilazimika	wa li lazim ik a	lazim
walileta	wa li let a	let
walilia	wa li li a	li
walinituma	wa li ni tum a	tum
walinusurika	wa li nu surik a	surik
walio	wa li o	li
Walioathirika	Wa li o athir ik a	athir
walioathiriwa	wa li o athiri w a	athiri
waliobaki	wa li o baki	baki
waliohusika	wa li o hus ik a	hus
waliojenga	wa li o jeng a	jeng
waliokaribiana	wa li o karibi an a	karibi
waliokimbia	wa li o kimbi a	kimbi
walioko	wa li o k<o>	k<o>
waliokolewa	wa li oko lew a	oko 
waliokua	wa li o ku a	ku
waliokubaliwa	wa li o ku bali w a	bali
waliokufa	wa li o kuf a	kuf
waliomba	wa li omb a	omb
walionufaika	wa li o nufa ik a	nufa
walionusurika	wa li o nu surik a	surik
walioondolewa	wa li o ondo lew a	ondo
waliopimwa	wa li o pim w a	pim
waliopo	wa li o po	po
waliopotelewa	wa li o pot e lew a	pot
waliotambuliwa	wa li o tambu liw a	tambu 
walipata	wa li pat a	pat
walipo	wa li po	po
walipopoteza	wa li po pot ez a	pot
walipotia	wa li po ti a	po
walitabiri	wa li tabiri	tabiri
walitakiwa	wa li tak i w a	tak
walitii	wa li tii	tii
walitoa	wa li to a	to
waliuawa	wa li ua w a	ua
walivamia	wa li vami a	vami
walizozichukuwa	wa li zo zi chuku w a	chuku
wameachwa	wa me ach w a	ach
wameaga	wa me ag a	ag
wameambukizwa	wa me ambu k iz w a	ambu
wameamua	wa me amu a	amu
wamearifu	wa me arifu	arifu
wamechukuliwa	wa me chuku liw a	chuku
wameenda	wa me end a	end
wameendelea	wa me endele a	endele
wamehama	wa me ham a	ham
wamehifadhiwa	wa me hifadhi w a	hifadhi
wameishauri	wa me i shauri	shauri
wameishitaki	wa me i shitaki	shitaki
wamejipanga	wa me ji pang a	pang
wamejitahidi	wa me ji tahidi	tahidi
wamekimbilia	wa me kimbi li a	kimbi
wamekosa	wa me kos a	kos
wamekufa	wa me kuf a	kuf
wamekwama	wa me kwam a	kwam
wamelazimika	wa me lazim ik a	lazim
wamelazimishwa	wa me lazim ish w a	lazim
wamelazwa	wa me laz w a	laza
Wamempanikisha	Wa me m pan ik ish a	pan
wamemuachia	wa me mu ach i a	ach
wamemuambia	wa me mu amb i a	amb
wamemzuia	wa me m zui a	zui
wameogopa	wa me ogop a	ogop
wameona	wa me on a	on
wameondoka	wa me ondo k a	ondo
wamepewa	wa me p<e> w a	p<e>
wamepitisha	wa me pit ish a	pit
wamesafisha	wa me saf ish a	safa
wameshafunga	wa me sha fung a	fung
wameshakumbwa	wa me sha kumb w a	kumb
wameshatoa	wa me sha to a	to
wameshazikwa	wa me sha zik w a	zik
wamesikia	wa me siki a	siki
wametaja	wa me taj a	taj
wameteka	wa me tek a	tek
wametenga	wa me teng a	teng
wamethibitika	wa me thibit ik a	thibit
wameuliwa	wa me u liw a	liw
wamevamia	wa me vami a	vami
wamewapa	wa me wa p a	p
wameyakimbia	wa me ya kimbi a	kimbi
wamezoea	wa me zoe a	zoe
wanabaki	wa na baki	na
wanadai	wa na dai	na
wanadaiwa	wa na dai w a	na
wanaendelea	wa na endele a	endele
wanafahamu	wa na fahamu	fahamu
wanafanya	wa na fany a	fany
Wanafunzi	Wa na funzi	an
wanahabari	wa na habari	na
wanahama	wa na ham a	ham
wanahitaji	wa na hitaji	hitaji
wanahofiwa	wa na hofi w a	hofi
wanaiba	wa na ib a	ib
wanaimba	wa na imb a	imb
wanajamii	wa na jamii	an
wanajaribu	wa na jaribu	jaribu
wanakijiji	wa na ki ji ji	an
wanakwenda	wa na kw end a	end
wanalinda	wa na lind a	lind
wanamtaka	wa na m tak a	tak
wananchi	wa na nchi	an
wanao	wa na o	o
wanaoambukizwa	wa na o ambu k iz w a	ambu
wanaohama	wa na o ham a	ham
wanaohusika	wa na o hus ik a	hus
wanaoishi	wa na o ishi	ishi
wanaokadiriwa	wa na o kadiri w a	kadiri
wanaona	wa na on a	on
wanaosafiri	wa na o safiri	safiri
wanaougua	wa na o ugu a	ugu
Wanaozaliwa	Wa na o zali w a	zali
wanapofanya	wa na po fany a	fany
wanapofariki	wa na po fariki	fariki
wanaposhuhudia	wa na po shuhudi a	shuhudi
wanasadikiwa	wa na sadiki w a	sadiki
wanasayansi	wa na sayansi	an
wanasema	wa na sem a	sem
wanashikiliwa	wa na shiki liw a	shiki
wanasiasa	wa na siasa	an
wanasubiria	wa na subir i a	subir
wanatafakari	wa na ta fakari	ta fakari
wanatafuta	wa na tafut a	tafut
wanatakiwa	wa na tak i w a	tak
wanatarajia	wa na taraji a	taraji
wanatibiwa	wa na tibi w a	tibi
wanatumia	wa na tum i a	tum
wanaumwa	wa na um w a	um
wanavyotatizwa	wa na vyo tat iz w a	tat
wanavyouchakaza	wa na vyo u cha kaz a	kaz
Wanawake	Wa na wake	an
wanawatafuta	wa na wa tafut a	tafut
wanazohitaji	wa na zo hitaji	hitaji
wanazoishi	wa na zo ishi	ishi
wangali	wa ngali	ngali
wanne	wa nne	nne
Wanyama	Wa nyama	nyama
wanyamapori	wa nyama pori	nyama
waokoaji	wa o ko aji	ko
waongezeka	wa ongez ek a	ongez
waonya	wa ony a	ony
Wapakistani	Wa pakistani	pakistani
wapatao	wa pa ta o	ta
wapenzi	wa pen zi	pen
wapiganaji	wa pig an aji	pig
wapo	wa po	po
warudi	wa rudi	rudi
wasaidizi	wa saidi zi	saidi
washikiliwa	wa shiki liw a	shiki
WASHIKILIWA	WA SHIKI LIW A	SHIKI
washirikishwe	wa shirik ish w e	shirik
wasi	w asi	asi
wasiende	wa si end e	end
Wasimamizi	Wa simam iz i	simam
wasiokuwa	wa si o kuw a	kuw
wasipigwe	wa si pig w e	pig
wasithubutu	wa si thubutu	thubutu
wasiwasi	wasi wasi	wasi
Wataalam	Wa taalam	taalam
Wataalamu	Wa taalam u	taalam
watabiri	wa tabiri	tabiri
watakabiliwa	wa ta kabili w a	kabili
watakutana	wa ta kut an a	kut
watamfanyia	wa ta m fany i a	fanya
watapewa	wa ta p<e> w a	p<e>
watatoa	wa ta to a	to
watatumia	wa ta tum i a	tum
watawanyike	wa tawany ik e	tawany
wateja	wa tej a	tej
WATEKETEZA	WA TEKET EZ A	TEKET
watekwa	wa tek w a	tek
watishia	wa tish i a	tish
Watoto	Wa toto	toto
WATU	WA TU	TU
watumia	wa tum i a	tum
Waturkana	Wa turkana	turkana
wauguzi	wa ugu zi	ugu
wauwawa	wa uwa w a	uwa
WAVAMIZI	WA VAMI ZI	VAMI
Wavuvi	Wa vuvi	vuvi
WAVUVI	WA VUVI	VUVI
wawekwa	wa wek w a	wek
wazazi	wa zazi	zazi
wazi	wazi	zi
wazima	wa zim a	zim
wazitumie	wa zi tum i e	tum
wazuka	wa zuk a	zuk
wazungu	wa zungu	zungu
wengi	we ngi	we ngi
Wengine	W engine	engine
wenye	w enye	enye
wenyeji	wenye ji	wenye
Wenzake	Wenza ke	Wenza
Wetu	We tu	tu
Wiki	Wiki	Wiki
wiliyani	wiliya ni	wiliya
wimbo	w imb o	imb
wingi	w ingi	ingi
Wizara	Wizara	Wizara
wowote	wo wote	wote
ya	y a	a
yaani	yaani	yaani
yafanyike	ya fany ik e	fanya
yafuatayo	ya fuat a yo	fuat
yahusuyo	ya hus u yo	hus
yakamata	ya kamat a	kamat
yake	ya ke	ke
yakianza	ya ki anz a	anz
yakienda	ya ki end a	end
yakimwagika	ya ki mwag ik a	mwag
yakinyofolewa	ya ki nyofo lew a 	nyofo
yakisomba	ya ki somb a	somb
Yako	Ya ko	ko
yalaumiwa	ya laum i w a	laum
yale	ya le	le
yaleta	ya let a	let
yalioenea	ya li o ene a	ene
yaliotokea	ya li o tok e a	tok
yalipofika	ya li po fik a	fik
yalisababisha	ya li sabab ish a	sabab
yalisema	ya li sem a	sem
yalitabiriwa	ya li tabiri w a	tabiri
yaliyo	ya li yo	li
yaliyoathirika	ya li yo athir ik a	athir
yaliyoathiriwa	ya li yo athiri w a	athiri
yaliyofunga	ya li yo fung a	fung
yaliyoingia	ya li yo ingi a	ingi
yaliyojiri	ya li yo jiri	jiri
yaliyolaumiwa	ya li yo laum i w a	laum
yaliyosababisha	ya li yo sabab ish a	sabab
yaliyosababishwa	ya li yo sabab ish w a	sabab
yaliyoshtushwa	ya li yo shtu sh w a	shtu
yaliyotokea	ya li yo tok e a	tok
yaliyotolewa	ya li yo to lew a	to
yameanzisha	ya me anz ish a	anz
yameathiri	ya me athiri	athiri
yamechangia	ya me chang i a	chang
yamechukua	ya me chuku a	chuku
yamedhibitiwa	ya me dhibiti w a	dhibiti
yameelezwa	ya me elez w a	elez
yameharibika	ya me harib ik a	harib
yameharibiwa	ya me haribi w a	haribi
yamekatwa	ya me kat w a	kata
yamelazimu	ya me lazim u	lazim
yameondoa	ya me ondo a	ondo
yameongeza	ya me ongez a	ongez
yamepelekwa	ya me pelek w a	pelek
yamesababishwa	ya me sabab ish w a	sabab
yamesemwa	ya me sem w a	sem
yamesombwa	ya me somb w a	somb
yametajwa	ya me taj w a	taj
yametokea	ya me tok e a	tok
yamewafikia	ya me wa fik i a	fik
yana	ya na	na
yanaarifu	ya na arifu	arifu
yanahusiana	ya na hus i an a	hus
yanajaribu	ya na jaribu	jaribu
yanakumbwa	ya na kumb w a	kumb
yanaonekana	ya na on ek an a	on
yanapokwama	ya na po kwam a	kwam
yanatarajiwa	ya na taraji w a	taraji
yanatokana	ya na tok an a	tok
yanaungwa	ya na ung w a	ung
yanavyoongezeka	ya na vyo ongez ek a	ongez
yanayofanana	ya na yo fan an a	fan
yanayohofiwa	ya na yo hofi w a	hofi
yanayohusiana	ya na yo hus i an a	hus
yanayohusishwa	ya na yo hus ish w a	hus
yanayopakana	ya na yo pak an a	pak
yanayotokana	ya na yo tok an a	tok
yanayovuja	ya na yo vuj a	vuj
yanayowapata	ya na yo wa pat a	pat
yanayozunguka	ya na yo zunguk a	zunguk
yangu	y angu	angu
yaongezeka	ya ongez ek a	ongez
yapitia	ya piti a	piti
yapokonya	ya pokony a	pokony
yasababisha	ya sabab ish a	sabab
yasiwadhuru	ya si wa dhuru	dhuru
yasiyofaa	ya si yo fa a	fa
yataendelea	ya ta endele a	endele
yatakuwa	ya ta kuw a	kuw
yathibitisha	ya thibit ish a	thibit
YATOA	YA TO A	TO
YATUMA	YA TUM A	TUM
yaua	ya ua	ua
yazidi	ya zidi	zidi
yenyewe	y enye we	enye
yote	y ote	ote
yuko	yu ko	yu
yupo	yu po	yu
ZA	ZA	ZA
zaharibiwa	za haribi w a	haribi
ZAIDI	ZAIDI	ZAIDI
zake	za ke	ke
Zamani	Zamani	Zamani
zao	za o	za
zenye	z enye	enye
zetu	ze tu	ze 
ziara	ziara	ziara
zigawiwe	zi gaw i w e	gaw
zikikosa	zi ki kos a	kos
zikiwemo	zi ki wemo	wemo
zikiwepo	zi ki we po	po
zikizima	zi ki zim a	zim
ziko	zi ko	ko
zilianza	zi li anz a	anz
zilibomolewa	zi li bomo lew a	bomo
ziliharibiwa	zi li haribi w a	haribi
zilikumbwa	zi li kumb w a	kumb
zilikuwa	zi li kuw a	kuw
zilipata	zi li pat a	pat
zilisimamishwa	zi li simam ish w a	simam
zilitarajia	zi li taraji a	taraji
zilizikwa	zi li zik w a	zik
zilizingirwa	zi li zingir w a	zingir
zilizobomolewa	zi li zo bomo lew a	bomo
zilizojaa	zi li zo ja a	ja
zilizokataa	zi li zo kata a	kata
zilizokumbwa	zi li zo kumb w a	kumb
zilizokuwa	zi li zo kuw a	kuw
zilizonyesha	zi li zo ny esh a	ny
zilizopimwa	zi li zo pim w a	pim
Zilizopita	Zi li zo pit a	pit
zilizosombwa	zi li zo somb w a	somb
zima	zima	zima
zimamoto	zima moto	moto
zimeahidi	zi me ahidi	ahidi
zimefukiwa	zi me fuki w a	fuki
zimehama	zi me ham a	ham
zimehifadhiwa	zi me hifadhi w a	hifadhi
zimejengwa	zi me jeng w a	jeng
zimekamilika	zi me kamil ik a	kamil
zimekumbwa	zi me kumb w a	kumb
zimekuwa	zi me kuw a	kuw
zimeleta	zi me let a	let
zimeletwa	zi me let w a	let
zimemalizika	zi me maliz ik a	maliz
zimepunguza	zi me pung uz a	pung
zimeripotiwa	zi me ripoti w a	ripoti
zimesambazwa	zi me samba z w a	samba
zimeshindwa	zi me shind w a	shind
zimetatizika	zi me tatiz ik a	tatiz
zimetokea	zi me tok e a	tok
zimetumwa	zi me tum w a	tum
zimeungana	zi me ung an a	ung
zina	zi na	na
zinaendelea	zi na endele a	endele
zinafahamu	zi na fahamu	fahamu
zinakanganya	zi na kangany a	kangany
zinakuja	zi na kuj a	kuj
zinanyesha	zi na ny esh a	ny
zinaonesha	zi na on esh a	on
zinasema	zi na sem a	sem
zinatarajiwa	zi na taraji w a	taraji
zinatoka	zi na tok a	tok
zinatokana	zi na tok an a	tok
zinatolewa	zi na to lew a	to
zinaweza	zi na wez a	wez
zinazofanywa	zi na zo fany w a	fanya
zinazohusika	zi na zo hus ik a	hus
zinazoishi	zi na zo ishi	ishi
zinazotakiwa	zi na zo tak i w a	tak
zinazowasafirisha	zi na zo wa safir ish a	safir
zinazozalisha	zi na zo za li sh a	za
zipo	zi po	po
zisikutoe	zi si ku to e	to
zisizo	zi si zo	zo
zitanyesha	zi ta ny esh a	ny
zitasaidia	zi ta saidi a	saidi
zitatumika	zi ta tum ik a	tum
zito	zito	zito
zote	z ote	ote
