token	segmentation	root
aabot	a abot	abot
aarestuhin	a arest<u> hin	arest<u>
abnormalidad	ab normal idad	normal 
abo	abo	abo
abot	abot	abot
adbokasiya	adbokasiya	adbokasiya
Adik	Adik	Adik
administrasyong	administra syon g	administra 
Agad	Agad	Agad
agaran	aga<r> an	aga<r> 
ahensiya	ahensiya	ahensiya
akala	akala	akala
akda	akda	akda
aking	akin g	akin 
ako	ako	ako
akong	ako ng	ako 
aktibista	aktib ista	aktib
aktibong	aktib ong	aktib 
alaala	alaala	alaala
alam	alam	alam
alamin	alam in	alam 
alarma	alarma	alarma
alas	alas	alas
alerto	alerto	alerto
alisto	a listo	listo
ALITERASYON	A LITERA SYON	LITERA 
alon	alon	alon
Amerikanong	Amerika no ng	Amerika 
amihan	amihan	amihan
amin	amin	amin
amoy	amoy	amoy
anak	anak	anak
anay	anay	anay
Ang	Ang	Ang
ani	ani	ani
anibersaryo	anibersaryo	anibersaryo
Animnapung	Anim na pu ng	Anim 
Aniya	A niya	A
ano	ano	ano
Año	Año	Año
anomalya	anomalya	anomalya
antisipasyon	antisipa syon	antisipa 
anu-ano	anu - ano	anu 
anumang	an<u> man g	an<u> 
anya	a nya	a
anyos	anyos	anyos
APAT	APAT	APAT
apatnapung	apat na pu ng	apat 
apektado	apekta do	apekta
apektadong	apekta do ng	apekta 
apektuhan	apekt<u> han	apekt<u>
apoy	apoy	apoy
araw	araw	araw
ari	ari	ari
ari-arian	ari - ari an	ari 
Arnel	Arnel	Arnel
ASONANS	ASONANS	ASONANS
at	at	at
atin	atin	atin
ating	atin g	atin 
Australian	Australia n	Australia 
autoridad	autoridad	autoridad
Awtonomo	Awtonomo	Awtonomo
awtoridad	awtoridad	awtoridad
ay	ay	ay
ayaw	ayaw	ayaw
Ayoko	Ay<o> ko	Ay<o>
ayon	ayon	ayon
ba	ba	ba
baba	baba	baba
bababa	ba baba	baba
babae	babae	babae
babaeng	babae ng	babae 
babala	babala	babala
baboy	baboy	baboy
Bagama't	Bagama 't	Bagama 
bagaman	bagaman	bagaman
Bagamat	Bagama <t>	Bagama 
bagamat	bagama t	bagama 
bagay	bagay	bagay
bago	bago	bago
bagong	bago ng	bago 
bagyo	bagyo	bagyo
BAGYONG	BAGYO NG	BAGYO
baha	baha	baha
Bahagi	Bahagi	Bahagi
bahagyang	bahagya ng	bahagya 
bahain	baha in	baha 
bahay	bahay	bahay
baka	baka	baka
Bakit	Bakit	Bakit
bala	bala	bala
balakid	balakid	balakid
Balete	Balete	Balete
balita	balita	balita
balota	balota	balota
banal	banal	banal
Banda	Banda	Banda
Bandang	Banda ng	Banda 
banggitin	banggit in	banggit
bangin	bangin	bangin
bangkay	bangkay	bangkay
Bangon	Bangon	Bangon
banig	banig	banig
bansa	bansa	bansa
bansang	bansa ng	bansa 
bantayan	bantay an	bantay
banyaga	banyaga	banyaga
barangay	barangay	barangay
baril	baril	baril
basa	basa	basa
basang	basa ng	basa 
basbas	basbas	basbas
Base	Base	Base
basta	basta	basta
basta-bastang	basta - basta ng	basta
basurahan	basura han	basura
basyong	basyo ng	basyo 
bata	bata	bata
batang	bata ng	bata 
Batangueno	Batanguen o	Batanguen 
batay	batay	batay
batok	batok	batok
bawat	bawat	bawat
bayan	bayan	bayan
bayang	bayan g	bayan 
baybayin	baybay in	baybay 
baybaying-dagat	baybay in g - dagat	baybay
bayuhin	bay<u> hin	bay<u> 
baywang	baywang	baywang
beh	beh	beh
beses	beses	beses
Beth	Beth	Beth
bibigay	bi bigay	bigay
bida	bida	bida
bigas	bigas	bigas
bigo	bigo	bigo
bigyang-pansin	bigyan g - pansin	bigyan pansin
bihag	bihag	bihag
biktima	biktima	biktima
biktimang	biktima ng	biktima 
bilang	bilang	bilang
Bilibid	Bilibid	Bilibid
bilis	bilis	bilis
bilyong	bilyon g	bilyon 
binabahang	b in a baha ng	baha 
Binabantayan	B in a bantay an	bantay
binabayaran	b in a baya<r> an	baya<r>
Binaha	B in aha	B aha
binahang	b in aha ng	b aha 
Binalaan	B in alaan	B alaan
Binasura	B in asura	B asura
binawi	b in awi	b awi
binawian	b in awi an	b awi
binayaran	b in aya<r> an	b aya<r>
binili	b in ili	b ili
bintana	bintana	bintana
binti	binti	binti
binubuo	b in u buo	buo
binugahan	b in uga han	b uga
Binuksang	B in uksan g	B uksan 
binuo	b in uo	b uo
bisa	bisa	bisa
bisinidad	bisinidad	bisinidad
bisitahin	bisita hin	bisita 
biskwet	biskwet	biskwet
Bitong	Bitong	Bitong
Biyahe	Biyahe	Biyahe
Biyernes	Biyernes	Biyernes
boboto	bo boto	boto
bohol	bohol	bohol
bomba	bomba	bomba
Bombo	Bombo	Bombo
Bong	Bong	Bong
Buayan	Buayan	Buayan
bubong	bubong	bubong
bugok	bugok	bugok
bugso	bugso	bugso
buhawi	buhawi	buhawi
buhay	buhay	buhay
buhok	buhok	buhok
buhos	buhos	buhos
Bukas	Bukas	Bukas
Bukod	Bukod	Bukod
bulkan	bulkan	bulkan
bulnerabilidad	bulnerabil idad	bulnerabil 
bulnerable	bulnerable	bulnerable
bumagal	b um agal	b agal
Bumagsak	B um agsak	B agsak
bumalik	b um alik	b alik
bumbero	bumbero	bumbero
bumihag	b um ihag	b ihag
bumisitang	b um isita ng	b isita 
bumoto	b um oto	b oto
Bumulusok	B um ulusok	B ulusok
bundok	bundok	bundok
bunsod	bunsod	bunsod
buntis	buntis	buntis
buntot	buntot	buntot
buong	buo ng	buo 
bus	bus	bus
buwan	buwan	buwan
camatchili	camatchili	camatchili
Chino	Chino	Chino
cnasabihan	c na sabi han	sabi
craan	cra an	cra
Cruz	Cruz	Cruz
cya	cya	cya
daambakal	daa<m> bakal	daa<m> bakal
daan	daan	daan
daan-daang	daan - daan g	daan
daanan	daan an	daan 
dadalhin	da dalhin	dalhin
dagat	dagat	dagat
dagdag	dagdag	dagdag
dahil	dahil	dahil
dahilan	dahil an	dahil 
daigdig	daigdig	daigdig
dakong	dako ng	dako 
dala	dala	dala
dalawa	dalawa	dalawa
dalawang	dalawa ng	dalawa 
dalhin	dal hin	dal 
dali	dali	dali
daloy	daloy	daloy
dami	dami	dami
damit	damit	damit
danyos	danyos	danyos
Dapat	Dapat	Dapat
darating	da <r>ating	<r>ating
Dasalin	Dasal in	Dasal 
dating	dati ng	dati 
datos	datos	datos
daw	daw	daw
dayami	dayami	dayami
dayuhan	day<u>  han	day<u> 
del	del	del
delikado	delikado	delikado
delubyo	delubyo	delubyo
Dentista	Dentist a	Dentist 
depende	depende	depende
desisyon	desisyon	desisyon
dhil	dhil	dhil
dhilan	dhil an	dhil 
di	di	di
di-kukulangin	di - ku kulang in	kulang
dibisyon	dibisyon	dibisyon
dikit-dikit	dikit - dikit	dikit
Dilasag	Dilasag	Dilasag
din	din	din
Dinagat	D in agat	D agat
dinala	d in ala	d ala
dinarayo	d in a <r>ayo	d <r>ayo
ding	di ng	di 
dinulot	d in ulot	d ulot
direksyon	direk syon	direk 
direksyong	direk syon g	direk 
dis	dis	dis
distrito	distrito	distrito
Disyembre	Disyembre	Disyembre
dito	dito	dito
diyan	diyan	diyan
Diyos	Diyos	Diyos
dlyar	dlyar	dlyar
doktor	doktor	doktor
doktora	doktor a	doktor 
doon	doon	doon
dormitoryo	dormitoryo	dormitoryo
Dos	Dos	Dos
dosenang	dose na ng	dose 
dpat	dpat	dpat
dugo	dugo	dugo
dulot	dulot	dulot
dumaan	d um aan	d aan
Dumagundong	D um agundong	D agundong
dumaluhong	d um aluhong	d aluhong
dumami	d um ami	d ami
dumating	d um ating	d ating
dumi	dumi	dumi
dumulog	d um ulog	d ulog
durugin	dur<u>g in	dur<u>g 
dyip	dyip	dyip
ebakwasyon	ebakwa syon	ebakwa 
edad	edad	edad
EDITORYAL	EDITOR YAL	EDITOR
eh	eh	eh
ekonomiya	ekonomiya	ekonomiya
eksplorasyon	eksplora syon	eksplora 
ektarya	ektarya	ektarya
eleksiyon	elek siyon	elek
eleksyon	elek syon	elek 
embahada	embahada	embahada
entablado	en tabla do	tabla
eroplanong	eroplano ng	eroplano 
estado	estado	estado
estratehiya	estratehiya	estratehiya
estudyante	estudyante	estudyante
estudyanteng	estudyante ng	estudyante 
Fil	Fil	Fil
Filipinas	Filipinas	Filipinas
FILIPINO	FILIPIN O	FILIPIN 
gaano	ga ano	ano
gabi	gabi	gabi
gagamitin	ga gamit in	gamit 
gahamang	gahaman g	gahaman 
gahiganteng	ga higante ng	higante 
galing	galing	galing
gamit	gamit	gamit
gamot	gamot	gamot
GANAP	GANAP	GANAP
Gang	Gang	Gang
ganid	ganid	ganid
Ganito	Ganito	Ganito
ganitong	ganito ng	ganito 
ganun	ganun	ganun
ganung	ganun g	ganun 
ganuong	gan<u>on g	gan<u>on 
ganyang	ganyan g	ganyan 
gastusin	gast<u>s in	gast<u>s 
gatas	gatas	gatas
gawa	gawa	gawa
Gawad	Gawad	Gawad
Gawin	Gawin	Gawin
gawing	gawin g	gawin 
gaya	gaya	gaya
gayahin	gaya hin	gaya 
gayundin	ga<y>un din	ga<y>un 
gilid	gilid	gilid
ginagalit	g in a galit	galit
ginagamot	g in a gamot	gamot
ginawa	g in awa	g awa
ginugulo	g in u gulo	g gulo
gitna	gitna	gitna
gobyerno	gobyerno	gobyerno
granada	granada	granada
grupo	grupo	grupo
grupong	grupo ng	grupo 
guho	guho	guho
gulang	gulang	gulang
gulay	gulay	gulay
gulo	gulo	gulo
gumagawa	g um a gawa	gawa
gumalaw	g um alaw	g alaw
Gumawa	G um awa	G awa
Gumuho	G um uho	G uho
gumuhong	g um uho ng	g uho 
guro	guro	guro
gusali	gusali	gusali
gusto	gusto	gusto
habagat	habagat	habagat
Habang	Habang	Habang
Haing	Hain g	Hain 
hakbang	hakbang	hakbang
hakot	hakot	hakot
halaga	halaga	halaga
halalan	halal an	halal 
halayin	halay in	halay 
halikan	halik an	halik 
halimbawa	halimbawa	halimbawa
halip	halip	halip
Halos	Halos	Halos
handa	handa	handa
hangang	hangang	hangang
Hanggang	Hanggang	Hanggang
hangin	hangin	hangin
hanging	hangin g	hangin 
hantungan	hant<u>ng an	hant<u>ng 
Hapon	Hapon	Hapon
Hapones	Hapon es	Hapon
harangin	harang in	harang 
harap	harap	harap
harapin	harap in	harap 
hatid	hatid	hatid
hehe	hehe	hehe
hektarya	hektarya	hektarya
helikopter	helikopter	helikopter
hepe	hepe	hepe
higanteng	higante ng	higante 
higit	higit	higit
hihi	hihi	hihi
hihigupin	hi hig<u>p in	hig<u>p 
Hihintayin	Hi hintay in	hintay
hilaga	hilaga	hilaga
hilagang	hilaga ng	hilaga 
hilagang-silangan	hilaga ng - silangan	hilaga silangan
hilaw	hilaw	hilaw
hiling	hiling	hiling
hilong-talilong	hilo ng - talilong	hilo talilong
himapapawid	himapapawid	himapapawid
himpapawid	himpapawid	himpapawid
himpilan	himpil an	himpil 
hinabol	h in abol	h abol
Hinahanap	H in a hanap	hanap
hinahatak	h in a hatak	hatak
hinanap	h in anap	h anap
hinayaan	h in ayaan	h ayaan
HINDI	HINDI	HINDI
hinggil	hinggil	hinggil
Hinimok	H in imok	H imok
hirap	hirap	hirap
hiwalay	hiwalay	hiwalay
hugong	hugong	hugong
Huling	Huli ng	Huli 
humagupit	h um agupit	h agupit
humampas	h um ampas	h ampas
humanap	h um anap	h anap
humantong	h um antong	h antong
humihingi	h um i hingi	hingi
humingi	h um ingi	h ingi
huminto	h um into	h into
humpay	humpay	humpay
humupa	h um upa	h upa
Hunyo	Hunyo	Hunyo
husgahan	husga han	husga 
husto	husto	husto
Huwag	Huwag	Huwag
Huweb	Huweb	Huweb
ianunsyo	i anunsyo	anunsyo
iba	iba	iba
iba't	iba 't	iba
ibabalik	i ba balik	balik
ibabaw	ibabaw	ibabaw
Ibahagi	I bahagi	bahagi
ibalik	i balik	balik
ibang	iba ng	iba 
ibasura	i basura	basura
ibat	iba t	iba
ibat-ibang	iba t - iba ng	iba iba
ibayo	ibayo	ibayo
ibibigay	i bi bigay	bigay
ibig	ibig	ibig
ibinahagi	i b in ahagi	b ahagi
ibinalibag	i b in alibag	b alibag
Ibinalita	I b in alita	b alita
ID	ID	ID
idamay	i damay	damay
ideklarang	i deklara ng	deklara
Idinagdag	I d in agdag	d agdag
idineklara	i d in eklara	d eklara
idulot	i dulot	i dulot
ihi	ihi	ihi
iiral	i iral	iral
Iisa	I isa	isa
iisang	i isa ng	isa
ika-anim	ika - anim	anim
ika-walo't	ika - walo 't	walo
ikalawang	ika lawa ng	lawa
IKAMATAY	I KA <M>ATAY	<M>ATAY
ikatlong	ika tlo ng	tlo 
ikinakasang	i k in a kasa ng	kasa
ikinalungkot	i k in a lungkot	lungkot
ikinamatay	i k in a <m>atay	<m>atay
ikinasugat	i k in a sugat	sugat
ilalagay	i la lagay	lagay
ilalim	i lalim	lalim
ilan	ilan	ilan
ILANG	ILAN G	ILAN
ilaw	ilaw	ilaw
iligal	i ligal	ligal
ilog	ilog	ilog
imanipula	i manipula	manipula
imbestigasyon	imbestiga syon	imbestiga 
impastraktura	impastraktura	impastraktura
impeksyon	impek syon	impek 
impormasyon	imporma syon	imporma 
imprastraktura	imprastraktura	imprastraktura
imprastraktural	imprastraktura l	imprastraktura 
imprastruktura	imprastruktura	imprastruktura
in	in	in
Inaalam	In a alam	alam
Inaasahan	In a asa han	asa
Inaasahang	In a asa han g	asa
inaasam-asam	in a asam - asam	asam
inabot	in abot	abot
inabutan	in ab<u>t an	ab<u>t 
inako	in ako	ako
inanod	in anod	anod
Inasal	In asal	asal
inay	inay	inay
Indayog	Indayog	Indayog
Indian	India n	India 
Indiano	India n o	India 
Indonesian	Indonesia n	Indonesia 
Ingat	Ingat	Ingat
ingatan	ingat an	ingat 
Ingay	Ingay	Ingay
inihahatid	in i ha hatid	hatid
inihatid	in i hatid	hatid
inihayag	in i hayag	hayag
iniingatang	in i ingat an g	ingat
inilarga	in i larga	larga
Inilista	In i lista	lista
iniluluwas	in i lu luwas	luwas
inisyal	inisyal	inisyal
init	init	init
Iniulat	In i ulat	ulat
insedente	insedente	insedente
insidente	insidente	insidente
instalasyon	instala syon	instala 
interbyu	interbyu	interbyu
inumin	in<u>m in	in<u>m 
Inuulit	In u ulit	ulit
inyon	inyo n	inyo 
inyong	inyo ng	inyo 
ipaayos	i pa ayos	ayos
ipagdasal	i pag dasal	dasal
ipagharap	i pag harap	harap
ipatitigil	i pa ti tigil	tigil
ipinadadala	i p in a da dala	dala
Ipinagpatuloy	I p in ag pa tuloy	tuloy
Ipinakikita	I p in a ki kita	kita
Ipinanukala	I p in anukala	p anukala
ipinasara	i p in a sara	sara
ipinaskil	i p in askil	p askil
ipinatupad	i p in a tupad	tupad
ipinaubaya	i p in aubaya	p aubaya
iresponsableng	i responsable ng	responsable 
isa	isa	isa
isagawa	i sa gawa	gawa
isandaan	isa n daan	isa daan
isang	isa ng	isa 
isasailalim	i sa sa ilalim	ilalim
isasama	i sa sama	sama
Isidro	Isidro	Isidro
isinaad	i s in aad	s aad
Isla	Isla	Isla
istagnanteng	istagnante ng	istagnante 
istasyon	istasyon	istasyon
istruktura	istruktura	istruktura
itataas	i ta taas	taas
itatawag	i ta tawag	tawag
ITIM	ITIM	ITIM
Itinaas	I t in aas	t aas
itinago	i t in ago	t ago
ito	ito	ito
itong	ito ng	ito 
iwasan	iwas an	iwas 
Iyan	Iyan	Iyan
iyon	iyon	iyon
juskuday	<j><u>sk<u> day	<j><u>sk<u>
ka	ka	ka
ka-opisina	ka - opis in a	opis 
Kaagad	Ka agad	agad
kaakibat	ka akibat	akibat
kaakit-akit	ka akit - akit	akit
kaalaman	ka alam an	alam
kabahayan	ka bahay an	bahay
kabayanihan	ka bayani han	bayani
KABI-KABILA	KA BI - KABILA	KABILA
kabiguan	ka big<u> an	big<u> 
kabila	kabila	kabila
kabilang	kabila ng	kabila 
Kabisayaan	Ka bisaya an	bisaya
kable	kable	kable
kabuhayan	ka buhay an	buhay
kadalasan	ka dalas an	dalas
kadalasang	ka dalas an g	dalas
kadalisayan	ka dalisay an	dalisay
kagabi	ka gabi	gabi
kagagawan	ka ga gawan	gawan
kagamitan	ka gamit an	gamit
kagamitang	ka gamit an g	gamit
kagat	kagat	kagat
Kagawad	Kagawad	Kagawad
kaginhawaan	ka ginhawa an	ginhawa
kagubatan	ka gubat an	gubat
Kahapon	Ka hapon	hapon
kahit	kahit	kahit
Kahoy	Kahoy	Kahoy
kailangan	kailangan	kailangan
kailangang	kailangan g	kailangan 
kailanman	kailan man	kailan
KAISA	KA ISA	ISA
Kakaiba	Ka ka iba	iba
kakailanganin	ka kailangan in	kailangan
kakulangan	ka kulang an	kulang
kalagayan	ka lagay an	lagay
kalahati	ka la hati	hati
kalahating	kala hati ng	hati
kalakas	ka lakas	lakas
kalakasan	ka lakas an	lakas
Kalaklan	Kalaklan	Kalaklan
kalapit	ka lapit	lapit
kalat	kalat	kalat
kalibre	kalibre	kalibre
kaligtasan	ka ligtas an	ligtas
kalikasan	ka likas an	likas
kalimitang	ka limita ng	limita
kalimutan	ka lim<u>t an	lim<u>t 
kalinisan	ka linis an	linis
kalsada	kalsada	kalsada
kalsadang	kalsada ng	kalsada 
kalunos-lunos	ka lunos - lunos	lunos
kalupaan	ka lupa an	lupa
kalusugan	ka lus<u>g an	lus<u>g 
kamalayan	ka malay an	malay 
kamalian	ka mali an	mali 
kamaliang	ka mali an g	mali 
kamanghaan	ka mangha an	mangha 
Kami	Kami	Kami
kaming	kami ng	kami 
KAMPANARYO	KAMPANAR YO	KAMPANAR
KAMPO	KAMPO	KAMPO
kamusta	kamusta	kamusta
kanang	kanan g	kanan 
kandidato	kandidat o	kandidat
Kandila	Kandila	Kandila
kang	ka ng	ka
kanila	ka nila	nila
kanilang	ka nila ng	nila 
kanina	kanina	kanina
kaninang	kanina ng	kanina 
kaniya	ka niya	niya
kaniyang	kaniya ng	kaniya 
kanluran	kanluran	kanluran
kanya	kanya	kanya
Kanya-kanyang	Kanya - kanya ng	kanya
Kanyang	Kanya ng	Kanya 
Kapag	Kapag	Kapag
kapalaran	ka pala<r> an	pala<r> 
kapaligiran	ka paligi<r> an	paligi<r> 
kapatid	kapatid	kapatid
kapayapaan	ka payapa an	payapa 
kapital	kapital	kapital
kapitbahay	kapit bahay	bahay
kapuluan	ka pul<u> an	pul<u> 
Kapuso	Ka puso	puso
kapwa	kapwa	kapwa
karagatan	ka <r>agat an	<r>agat 
karagatang	ka <r>agat an g	<r>agat
karagdagang	ka <r>agdag an g	<r>agdag
Karambola	Karam bola	bola
Karamihan	Ka <r>ami han	<r>ami 
karangalan	ka <r>angal an	<r>angal 
karaniwan	karaniwan	karaniwan
karatig	karatig	karatig
karne	karne	karne
karneng	karne ng	karne 
kasabay	ka sabay	sabay
kasagutan	ka sag<u>t an	sag<u>t 
kasalukuyan	kasalukuyan	kasalukuyan
kasalukuyang	kasalukuyan g	kasalukuyan 
kasama	ka sama	sama
kasapi	ka sapi	sapi
kasaysayan	ka saysay an	saysay 
kasi	kasi	kasi
kasing	kasi ng	kasi 
kasinungalingan	ka sinungaling an	sinungaling 
kaso	kaso	kaso
kasong	kaso ng	kaso 
kasu-kasuan	kasu - kasuan	kasuan
kasunduan	ka sund<u> an	sund<u> 
kasunod	ka sunod	sunod
katao	ka tao	tao
katatagpuan	ka ta  tagp<u> an	tagp<u> 
katawan	katawan	katawan
katiwalian	ka tiwali an	tiwali 
katiwasayan	ka tiwasay an	tiwasay 
Katotohanan	Ka toto han an	toto
katwirang	katwiran g	katwiran 
kaugnay	ka ugnay	ugnay
kaulapan	ka ulap an	ulap 
kaunlaran	ka unla<r> an	unla<r> 
kawalan	ka wala n	wala 
kay	kay	kay
kaya	kaya	kaya
kaya't	kaya 't	kaya 
kaya’y	kaya ’y	kaya 
kayang	kaya ng	kaya 
kayat	kaya t	kaya
kayo	kayo	kayo
kayong	kayo ng	kayo 
kaysa	kaysa	kaysa
kc	kc	kc
kidlat	kidlat	kidlat
kilikili	kilikili	kilikili
kilogramo	kilo gramo	kilo gramo
kilometro	kilo metro	kilo metro
kinababahala	kina ba bahala	bahala
kinakailangan	k in a kailangan	kailangan
kinalalagyan	k in a la lagyan	lagyan
Kinalaunan	K in a la<u>n an	la<u>n
Kinansela	K in ansel a	K ansel 
kinaumagahan	kina um aga han	um aga 
kinitil	k in itil	k itil
kinukumpuni	k in u kumpuni	kumpuni
Kinumpirma	K in umpirma	K umpirma
kita	kita	kita
kits	kits	kits
klase	klase	klase
klimatolohiya	klima to lo hiya	klima
kmanddto	k m anddto	k anddto
ko	ko	ko
komersiyal	komers i yal	komers 
Komisyon	Komisyon	Komisyon
kompanya	kompanya	kompanya
komunidad	komun idad	komun 
Koneksiyon	Konek siyon	Konek
koneksyon	konek syon	konek 
kong	ko ng	ko 
KONSONANS	KONSONAN S	KONSONAN 
koordinasyon	koordina syon	koordina 
Koordinasyong	Koordina syon g	Koordina 
korporasyon	korpora syon	korpora 
koryente	koryente	koryente
Krisis	Krisis	Krisis
Kristiyano	Kristiyan o	Kristiyan
kritikal	kritik al	kritik 
KRITIKO	KRITIKO	KRITIKO
kudarat	kudarat	kudarat
Kuha	Kuha	Kuha
kumakain	k um a kain	kain
kumakalat	k um a kalat	k a kalat
kumalat	k um alat	k alat
kumanddto	k um anddto	k anddto
kumbento	kumbento	kumbento
kumikilos	k um i kilos	kilos
kumilos	k um ilos	k ilos
kumot	kumot	kumot
kumpara	kumpara	kumpara
kumpimadong	kumpima do ng	kumpima 
kumpirmado	kumpirma do	kumpirma
kumpirmadong	kumpirma do ng	kumpirma 
kumplikasyon	kumplika syon	kumplika 
Kumusta	Kumusta	Kumusta
kundi	kun di	di
KUNG	KUNG	KUNG
Kungyangon	Kungyangon	Kungyangon
kuno	kuno	kuno
kur­yente	kur­yente	kur­yente
Kuryente	Kuryente	Kuryente
Kuta	Kuta	Kuta
kutsara	kutsara	kutsara
Kuya	Kuya	Kuya
Laban	Laban	Laban
labas	labas	labas
labing	labi ng	labi 
labis	labis	labis
Laganap	Laganap	Laganap
lagi	lagi	lagi
lagim	lagim	lagim
lagnat	lagnat	lagnat
LAGUNA	LAGUNA	LAGUNA
lahar	lahar	lahar
Lahat	Lahat	Lahat
lakas	lakas	lakas
Laki	Laki	Laki
lalabas	la labas	labas
Lalawigan	La lawig an	lawig
lalim	lalim	lalim
lalo	lalo	lalo
LALONG	LALO NG	LALO
lalong-lalo	lalo ng - lalo	lalo
laluna	lal<u> na	lal<u>
lamang	lamang	lamang
lamok	lamok	lamok
lang	lang	lang
lansangan	lansangan	lansangan
larawan	larawan	larawan
larawang	larawan g	larawan 
lawak	lawak	lawak
layo	layo	layo
layong	layon g	layon 
Lebantino	Lebantino	Lebantino
Libis	Libis	Libis
libo-libong	libo - libo ng	libo
ligtas	ligtas	ligtas
likas	likas	likas
likod	likod	likod
lilipad	li lipad	lipad
Limang	Lima ng	Lima 
lindol	lindol	lindol
linggo	linggo	linggo
linggong	linggo ng	linggo 
lingkod	lingkod	lingkod
liparin	lipa<r> in	lipa<r> 
litro	litro	litro
lokal	lokal	lokal
loob	loob	loob
lubog	lubog	lubog
lugar	lugar	lugar
Lugod	Lugod	Lugod
lulong	lulong	lulong
lumaban	l um aban	l aban
lumabas	l um abas	l abas
Lumalabas	L um a labas	labas
lumalala	l um a lala	lala
lumalayo	l um a layo	layo
lumambot	l um ambot	l ambot
lumang	luma ng	luma 
lumikas	l um ikas	l ikas
lumilipas	l um i lipas	lipas
Lumilipat	L um i lipat	lipat
lumindol	l um indol	l indol
lumubog	l um ubog	l ubog
Lunes	Lunes	Lunes
lungsod	lungsod	lungsod
lupa	lupa	lupa
lupain	lupa in	lupa 
lupang	lupa ng	lupa 
luv	luv	luv
ma-cardiac	ma - cardiac	cardiac
ma-recover	ma - recover	recover
maaari	ma a ari	a ari
maaaring	ma a ari ng	a ari 
maaliwalas	ma aliwalas	aliwalas
maapektuhan	ma <a>pekt<u> han	<a>pekt<u> 
maaring	ma ari ng	ari 
maayos	ma ayos	ayos
mababa	ma baba	baba
mababang	ma baba ng	baba
mabagsakan	ma bagsak an	bagsak
mabagsik	ma bagsik	bagsik
mabait	ma bait	bait
mabatong	ma bato ng	bato
mabigyan	ma bigyan	bigyan
Mabilis	Ma bilis	bilis
mabubulgar	ma bu bulgar	bulgar
mabuti	ma buti	buti
Macapagal	Macapagal	Macapagal
madaanan	ma daan an	daan
madadagdagan	ma da dagdag an	dagdag
madalas	ma dalas	dalas
MADALING	MA DALI NG	DALI
mag	mag	mag
mag-aaral	mag - a aral	aral
Mag-ingat	Mag - ingat	ingat
mag-landfall	mag - landfall	landfall
mag-operate	mag - operate	operate
magamit	ma gamit	gamit
Magandang	Ma ganda ng	ganda
magbababad	mag ba babad	babad
magbagsakan	mag bagsak an	bagsak
magbigay	mag bigay	bigay
magbitbit	mag bitbit	bitbit
magbitiw	mag bitiw	bitiw
magdadala	mag da dala	dala
magdamag	magdamag	magdamag
magdasal	mag dasal	dasal
magdudulot	mag du dulot	dulot
maghanda	mag handa	handa
maghapon	mag hapon	hapon
maghasik	mag hasik	hasik
maghintay	mag hintay	hintay
maghuhudyat	mag hu hudyat	hudyat
magiba	ma giba	giba
magiging	ma gi ging	ging
maging	maging	maging
magkabilang	mag kabila ng	kabila 
Magkahawig	Mag ka hawig	hawig
magkakaroon	mag ka ka roon	roon
Magkakaroon	Mag ka ka roon	roon
magkakasunod	mag ka ka sunod	sunod
magkaroon	mag ka roon	roon
magkasunod	mag ka sunod	sunod
magkasunog	mag ka sunog	sunog
maglakbay	mag lakbay	lakbay
magmasid	mag masid	masid
magmumula	mag mu mula	mula
magpatuloy	mag pa tuloy	tuloy
magsagawa	mag sa gawa	gawa
magsasagawa	mag sa sa gawa	gawa
magsasaka	mag sa saka	saka
magsisimula	mag si si mula	mula
magsisimulang	mag si si mula ng	mula
magtanghali	mag tanghali	tanghali
magtataas	mag ta taas	taas
magtuloy-tuloy	mag tuloy - tuloy	tuloy
magtulungan	mag tul<u>ng an	tul<u>ng 
magtungo	mag tungo	tungo
Magugunitang	Ma gu gunita ng	gunita
mahabang	ma haba ng	haba
mahagip	ma hagip	hagip
mahal	mahal	mahal
Mahalaga	Ma halaga	halaga
Mahalagang	Ma halaga ng	halaga
mahawa	ma hawa	hawa
Mahigit	Ma higit	higit
mahihinang	ma hi hina ng	hina
mahina	ma hina	hina
mahulog	ma hulog	hulog
mahulugang	ma hul<u>g a ng	hul<u>g 
maihahambing	ma i ha hambing	hambing
mainfect	ma infect	infect
mainit	ma init	init
mainterbyung	ma interbyu ng	interbyu 
maintindihan	ma intindi han	intindi 
maipapayo	ma i pa payo	payo
maireport	ma i report	report
maituturing	ma i tu turing	turing
maiwasan	ma iwas an	iwas 
maka-kalikasang	maka - ka likas an g	likas 
makabalik	maka balik	balik
makagat	ma kagat	kagat
makahawa	maka hawa	hawa
makaiwas	maka iwas	iwas
Makakatulong	Ma ka ka tulong	tulong
makaligtas	maka ligtas	ligtas
makamatay	maka <m>atay	<m>atay
makapaglandfall	maka pag landfall	landfall
makapagtanim	maka pag tanim	tanim
makaraang	maka raan g	raan 
MAKASALANAN	MA KA SALA NAN	SALA
makasaysayang	maka saysay an g	saysay
makatanggap	maka tanggap	tanggap
makatapos	maka tapos	tapos
makatawid	maka tawid	tawid
makatutulong	maka tu tulo ng	tulo 
Makikinig	Ma ki kinig	kinig
makikipagtulungan	ma ki ki pag tul<u>ng an	tul<u>ng 
Makikita	Ma ki kita	kita
makilala	ma kilala	kilala
makina	makina	makina
makitaan	ma kita an	kita 
makulimlim	ma ku limlim	limlim
mala-impiyernong	mala - impiyerno ng	impiyerno
malabong	ma labo ng	labo 
malagkit	ma lagkit	lagkit
malakas	ma lakas	lakas
Malaki	Ma laki	laki
malaking	ma laki ng	laki 
malalakas	ma la lakas	lakas
malalaking	ma la laki ng	laki
malalang	malala ng	malala 
Malalim	Ma lalim	lalim
malaman	m alam an	alam
malambot	ma lambot	lambot
malamig	ma lamig	lamig
malapit	ma lapit	lapit
malaria	malaria	malaria
malawakang	ma lawak an g	lawak 
Malayong	Ma layo ng	layo
mali	mali	mali
maliban	ma liban	liban
maligo	ma ligo	ligo
maligtas	ma ligtas	ligtas
maliit	ma liit	liit
maliitang	ma liit ang	liit
maliliit	ma li liit	liit
malilipatan	ma li lipat an	lipat
malinaw	ma linaw	linaw
malipol	ma lipol	lipol
maliwanag	ma liwanag	liwanag
malubhang	ma lubha ng	lubha 
malupit	ma lupit	lupit
Malvar	Malvar	Malvar
mamamayan	ma ma <m>ayan	<m>ayan
mamatay	ma <m>atay	<m>atay
mamu­lat   	ma mu­lat	mu­lat
managot	ma <n>agot	<n>agot
manalasa	ma nalasa	nalasa
Manambong	Ma <n>ambong	<n>ambong
mananakay	man a <n>akay	<n>akay
mananatiling	ma na natili ng	natili
Mandanas	Man danas	danas
mangamba	ma ngamba	ngamba
manggagaling	mang ga galing	galing
manggas	manggas	manggas
mangyayari	mang ya yari	yari
manira	ma <n>ira	<n>ira
mapa	mapa	mapa
mapaghandaan	ma pag handa an	pag handa 
mapaluwag	mapa luwag	luwag
mapanatili	ma pa natili	natili
mapanganib	ma panganib	panganib
mapanganib-sa-buhay	ma panganib - sa - buhay	panganib buhay
mapanglaw	ma panglaw	panglaw
Mapapakinggan	Ma pa pakin<g>g an	pakin<g>g
mapasok	ma pasok	pasok
mapinsala	ma pinsala	pinsala
mapupulang	ma pu pula ng	pula 
Maralitang	Maralita ng	Maralita 
marami	ma <r>ami	<r>ami
Maraming	Ma <r>ami ng	<r>ami 
mararanasang	ma ra <r>anasa ng	<r>anasa 
marunong	ma <r>unong	<r>unong
marurupok	ma ru rupok	rupok
Mas	Mas	Mas
masagip	ma sagip	sagip
masarap	ma sarap	sarap
masawing	ma sawi ng	sawi 
Masaya	Ma saya	saya
masayang	ma saya ng	saya 
Masbate	Masbate	Masbate
masyadong	masyado ng	masyado 
mata	mata	mata
mataas	ma taas	taas
matabunan	ma tab<u>n an	tab<u>n 
matadero	matader o	matader 
matagal	ma tagal	tagal
matalino	ma talino	talino
mataong	ma tao ng	tao 
Matapos	Ma tapos	tapos
matatagalan	ma ta tagal an	tagal
matatalo	ma ta talo	talo
matatanda	ma ta tanda	tanda 
Matatandaan	Ma ta tandaan	tandaan
matatapos	ma ta tapos	tapos
matatawag	ma ta tawag	tawag
materyal	materyal	materyal
materyales	materyal es	materyal
matilinghaga	ma tilinghaga	tilinghaga
matinding	ma tindi ng	tindi 
matinding-tinamaan	ma tindi ng - t in ama an	tindi t ama 
matiyak	ma tiyak	tiyak
matulungin	ma tul<u>ng in	tul<u>ng 
matusta	ma tusta	tusta
matuturing	ma tu turing	turing
matutusta	ma tu tusta	tusta
maulan	ma ulan	ulan
maulap	ma ulap	ulap
mawalan	ma wala n	wala 
MAY	MAY	MAY
may-asawa	may - asawa	asawa
mayamang	ma yaman g	yaman 
mayroon	may roon	roon
mayroong	may roon g	roon
mediko	medik o	medik
medikong	medik o ng	medik
Menor	Menor	Menor
meron	meron	meron
Metro	Metro	Metro
Mga	Mga	Mga
militar	militar	militar
milya	milya	milya
milyon	milyon	milyon
milyong	milyon g	milyon 
mina	mina	mina
miniro	min<i> ro	min<i> 
Ministro	Ministro	Ministro
minor	minor	minor
minsan	minsan	minsan
Minsteryo	Minsteryo	Minsteryo
minuto	minuto	minuto
Misis	Misis	Misis
mismo	mismo	mismo
Mistula	Mistula	Mistula
Mistulang	Mistula ng	Mistula 
miyembro	miyembro	miyembro
Miyerkules	Miyerkules	Miyerkules
mkkpag	mkkpag	mkkpag
MO	MO	MO
moske	moske	moske
motorista	motor ista	motor
motorsiklo	motor siklo	motor
mukha	mukha	mukha
mula	mula	mula
muling	muli ng	muli 
muna	muna	muna
munang	muna ng	muna 
mundo	mundo	mundo
mungkahi	mungkahi	mungkahi
munisipyo	munisipyo	munisipyo
muntik	muntik	muntik
n'yo	n'yo	n'yo
na	na	na
na-defuse	na - defuse	defuse
na-detect	na - detect	detect
na-survey	na - survey	survey
na-trap	na - trap	trap
Naabo	Na abo	abo
naanod	na anod	anod
naapektuhan	na apekt<u> han	apekt<u> 
Nabalisa	Na balisa	balisa
nabanggit	na banggit	banggit
nabaon	na baon	baon
nabasa	na basa	basa
Nabatid	Na batid	batid
nabigo	na bigo	bigo
nadaganan	na dagan an	dagan 
nadakip	na dakip	dakip
nadama	na dama	dama
nadarama	na da <r>ama	<r>ama
nadilaan	na dila an	dila 
nadurog	na durog	durog
nag	nag	nag
nag-aalaga	nag - a alaga	alaga
Nag-aalangan	Nag - a alangan	alangan
nag-alay	nag - alay	alay
nag-atas	nag - atas	atas
nag-iingat	nag - i ingat	ingat
nag-iisang	nag - i isa ng	isa
nag-imbita	nag - imbita	imbita
nag-overnight	nag - overnight	overnight
nag-uulan	nag - u ulan	ulan
nag-uulat	nag - u ulat	ulat
nagaganap	na ga ganap	ganap
naganap	na ganap	ganap
nagawa	na gawa	gawa
nagbabadya	nag ba badya	badya
Nagbabala	Nag babala	babala
nagbaon	nag baon	baon
nagbibigay	nag bi bigay	bigay
nagbigay	nag bigay	bigay
nagbuga	nag buga	buga
Nagdaan	Nag daan	daan
nagdaang	nag daan g	daan 
nagdadala	nag da dala	dala
nagdala	nag dala	dala
nagdeklara	nag deklara	deklara
nagdudusa	nag du dusa	dusa
nagdulot	nag dulot	lot
naghahanda	nag ha handa	handa
naghihintay	nag hi hintay	hintay
naghintay	nag hintay	hintay
naghuhugas	nag hu hugas	hugas
Nagiging	Na gi ging	ging
nagiispray	nag i ispray	ispray
naging	naging	naging
nagkakahalaga	nag ka ka halaga	halaga
nagkakarga	nag ka karga	karga
Nagkakaroon	Nag ka ka roon	roon
Nagkaroon	Nag ka roon	roon
nagkaroon	nag ka roon	roon
naglalakad	nag la lakad	lakad
naglalayong	nag la layon g	layon
Nagliparan	Nag lipa<r> an	lipa<r> 
Nagmadali	Nag ma dali	dali
nagmamay-ari	nag ma may - ari	may - ari
nagmula	nag mula	mula
nagmumula	nag mu mula	mula
nagnais	nag nais	nais
nagpa-alala	nag pa - alala	alala
nagpahirap	nag pa hirap	hirap
nagpalabas	nag pa labas	labas
nagpalubog	nag pa lubog	lubog
nagpapadala	nag pa pa dala	dala
nagpapagaling	nag pa pa galing	galing
nagpapaguho	nag pa pa guho	guho
nagpapahangin	nag pa pa hangin	hangin
nagpapatuloy	nag pa pa tuloy	tuloy
Nagparamdam	Nag pa <r>amdam	<r>amdam
NAGPASAKOP	NAG PA SAKOP	SAKOP
nagpataas	nag pa taas	taas
Nagpayo	Nag payo	payo
nagplano	nag plano	plano
nagra-rally	nag ra - rally	rally
nagresulta	nag resulta	resulta
nagsabi	nag sabi	sabi
nagsabing	nag sabi ng	sabi 
nagsagawa	nag sa gawa	gawa
nagsara	nag sara	sara
Nagsasagawa	Nag sa sa gawa	gawa
nagsasalubungan	nag sa salub<u>ng an	salub<u>ng 
nagsasayaw	nag sa sayaw	sayaw
Nagsimula	Nag si mula	mula
nagsisimula	nag si si mula	mula
nagsisiyasat	nag si siyasat	siyasat
nagsuspinde	nag suspinde	suspinde
nagsusurvey	nag su survey	su survey
Nagtapos	Nag tapos	tapos
nagtatanong	nag ta tanong	tanong
nagtatawanang	nag ta tawa nan g	tawa nan 
nagtutulakan	nag tu tulak an	tulak 
nagulat	na gulat	gulat
naha	naha	naha
nahahawang	na ha hawa ng	hawa
nahirapan	na hirap an	hirap 
nahuling	na huli ng	huli 
nahulog	na hulog	hulog
nailigtas	na i ligtas	ligtas
naimpluwensyahan	na impluwensya han	impluwensya 
naipit	na ipit	ipit
naipon	na ipon	ipon
naisin	nais in	nais 
naisipang	na isip an g	isip 
naistranded	na istranded	istranded
naisusugod	na i su sugod	sugod
naitala	na i tala	tala
naitalang	na i tala ng	tala 
naitatag	na i tatag	tatag
Naiulat	Na i ulat	ulat
naiuwi	na i uwi	uwi
naka	naka	naka
naka-assign	naka - assign	assign
Naka-PULA	Naka - PULA	PULA
nakaalerto	naka alerto	alerto
nakaambang	naka amba ng	amba 
nakagat	na kagat	kagat
nakahahawang	naka ha hawa ng	ha hawa 
Nakaharang	Naka harang	harang
nakakairita	naka ka irita	irita
nakakapanghina	naka ka pang hina	hina
nakakaramdam	naka ka <r>amdam	<r>amdam
nakakarimarim	naka ka rimarim	rimarim
nakakasakit	naka ka sakit	sakit
nakakasakop	naka ka sakop	sakop
nakakasilaw	naka ka silaw	silaw
nakakasira	naka ka sira	sira
nakakasunog	naka ka sunog	sunog
nakakatuyo	naka ka tuyo	tuyo
nakaligtas	naka ligtas	ligtas
nakalubog	naka lubog	lubog
Nakama-manghang	Naka ma - mangha ng	mangha 
nakapagdesisyon	nakapag desisyon	desisyon
nakapagresponde	nakapag responde	responde
nakapagtala	nakapag tala	tala
nakapalibot	naka pa libot	libot
nakapaloob	naka pa loob	loob
Nakapinsala	Naka pinsala	pinsala
Nakaproduce	Naka produce	produce
nakaraan	naka <r>aan	<r>aan
nakaraang	naka <r>aan g	<r>aan 
nakaranas	naka <r>anas	<r>anas
nakaratay	naka ratay	ratay
Nakaresponde	Naka responde	responde
Nakasaad	Naka saad	saad
nakasaksi	naka saksi	saksi
nakasasakop	naka sa sakop	sakop
nakasira	naka sira	sira
nakatayo	naka tayo	tayo
Nakatulog	Naka tulog	tulog
nakausap	naka usap	usap
nakauwi	naka uwi	uwi
nakikinig	na ki kinig	kinig
nakikipagtulungan	na ki ki pag tul<u>ng an	tul<u>ng
nakikitang	na ki kita ng	kita
nakilala	na kilala	kilala
nakilalang	na kilala ng	kilala 
nakipag	nakipag	nakipag
nakipagtalo	nakipag talo	talo
nakita	na kita	kita
Nakukuha	Na ku kuha	ku kuha
nakumpirma	na kumpirma	kumpirma
nalunod	na lunod	lunod
nalusutan	na lus<u>t an	lus<u>t 
namamatay	na ma <m>atay	<m>atay
naman	naman	naman
namang	naman g	naman 
namataan	na mata an	mata 
namatay	na <m>atay	<m>atay
namataysa	na <m>atay sa	<m>atay
namayapa	na <m>ayapa	<m>ayapa
namin	namin	namin
naming	namin g	namin 
nanalo	na nalo	nalo
nanaman	na naman	naman
nananalo	na na nalo	nalo
nananatili	na na natili	natili
nanatili	na natili	natili
nanawagan	na <n>awag an	<n>awag 
nang	nang	nang
nangaaway	nang a away	away
nangangalaga	na ng a ng alaga	alaga
nangangamba	na nga ngamba	ngamba
nanganganib	na nga nganib	nganib
nangingitlog	nang i <ng> itlog	itlog
nangyari	nang yari	yari
naninikwat	na ni <n>ikwat	<n>ikwat
naninirahan	na ni <n>ira han	<n>ira 
NANINIWALA	NA NI NIWALA	NIWALA
nanunuluyan	na nu <n> ul<u>y an	<n> ul<u>y 
Napag-alaman	Napag - alam an	alam
napag-alamanang	napag - alam an a ng	alam
napaghandaan	na pag handa an	handa
napaka-init	napaka - init	init
napakabilis	napaka bilis	bilis
napakadalas	napaka dalas	dalas
napakalakas	napaka lakas	lakas
napakalaking	napaka laki ng	laki
Napakarami	Napaka <r>ami	<r>ami
napalikas	na pa likas	likas
napanatili	na pa natili	natili
napansin	na pansin	pansin
napasakamay	na pa sa kamay	kamay
napatay	na patay	patay
napaulat	na pa ulat	ulat
napilitang	na pilit ang	pilit
napinsala	na pinsala	pinsala
naramdaman	na ramdam an	ramdam 
naranasan	na <r>anas an	<r>anas 
nararamdaman	na ra ramdam an	ramdam 
narekober	na rekober	rekober
narin	na <r>in	<r>in
narinig	na <r>inig	<r>inig
naroon	na <r>oon	<r>oon
Nasa	Na sa	sa
Nasaan	Na saan	saan
nasabing	na sabi ng	sabi 
nasaktan	na saktan	saktan
nasaktang	na saktan g	saktan 
nasalanta	na salanta	salanta
nasasalanta	na sa salanta	salanta
nasasama	na sa sama	sama
nasasangkot	na sa sangkot	sangkot
nasasawi	na sa sawi	sawi
nasasayang	na sa sayang	sayang
nasasecond	nasa second	second
nasawi	na sawi	sawi
nasawing	na sawi ng	sawi 
nasira	na sira	sira
nasirang	na sira ng	sira 
Nasugbu	Nasugbu	Nasugbu
nasundo	na sundo	sundo
nasunog	na sunog	sunog
nasusuri	na su suri	suri
nasyon	nasyon	nasyon
natabunan	na tab<u>nan	tab<u>nan
natabunang	na tab<u>nan g	tab<u>an
Natagpuan	Na tagp<u> an	tagp<u> 
natagpuang	na tagp<u> an g	tagp<u> 
natangay	na tangay	tangay
natanong	na tanong	tanong
natin	natin	natin
nating	natin g	natin 
natuklap	na tuklap	tuklap
natuklasan	na tuklas an	tuklas 
natukoy	na tukoy	tukoy
naturang	naturan g	naturan 
naubos	na ubos	ubos
naudyok	na udyok	udyok
Nauna	Na una	una
Nawala	Na wala	wala
nawalan	na wala n	wala 
nawalang	na wala ng	wala 
nawasak	na wasak	wasak
nawawala	na wa wala	wala
Nayon	Nayon	Nayon
NGA	NGA	NGA
ngayo'y	ngayo 'y	ngayo
Ngayon	Ngayon	Ngayon
Ngayong	Ngayon g	Ngayon 
nginangatngat	ngi na ngatngat	ngatngat
ngumiti	ng um iti	ng iti
Ngunit	Ngunit	Ngunit
ni	ni	ni
nila	nila	nila
nilalakad	ni la lakad	lakad
Nilamon	Ni lamon	lamon
nilang	nila ng	nila 
nilimitahan	ni limita han	limita 
nilinaw	ni linaw	linaw
nilindol	ni lindol	lindol
Nina	Nina	Nina
ninakaw	ni nakaw	nakaw
ninakawan	ni nakaw an	nakaw 
Nino	Nino	Nino
nito	nito	nito
nitó	nitó	nitó
nitong	nito ng	nito 
niya	niya	niya
niyan	niya n	niya 
niyang	niya ng	niya 
Niyanig	Ni yanig	yanig
niyebe	niyebe	niyebe
niyo	niyo	niyo
noong	noon g	noon 
Normal	Normal	Normal
Norte	Norte	Norte
notoryus	notoryus	notoryus
Nueva	Nueva	Nueva
numero	numero	numero
nun	nun	nun
nung	nu ng	nu 
nya	nya	nya
nyo	n yo	n yo
OKSIMORON	OKSIMORON	OKSIMORON
operatiba	operatiba	operatiba
opisina	opis in a	opis
opisyal	opis yal	opis
oras	oras	oras
organisasyon	organisa syon	organisa 
ospital	ospital	ospital
otoridad	otoridad	otoridad
otsentang	otsenta ng	otsenta 
pa	pa	pa
pa-timog	pa - timog	timog
Paalala	Pa alala	alala
paalisin	pa alis in	alis 
paanan	paa nan	paa
paano	paano	paano
paaralan	pa aral an	aral 
pabalik	pa balik	balik
pabrika	pabrika	pabrika
pabuya	pabuya	pabuya
pader	pader	pader
Padre	Padre	Padre
pag	pag	pag
pag-aalala	pag - a alala	alala
pag-aani	pag - a ani	ani
pag-aaral	pag - a aral	aral
pag-aari	pag - a ari	a ari
Pag-amin	Pag - amin	amin
pag-apaw	pag - apaw	apaw
pag-aralan	pag - aral an	aral 
pag-atake	pag - atake	atake
pag-iingat	pag - i ingat	ingat
pag-init	pag - init	init
pag-inspect	pag - inspect	inspect
pag-ulan	pag - ulan	ulan
pagamutan	pa gam<u>t an	gam<u>t 
pagbabanta	pag ba banta	banta
pagbabarilin	pag ba baril in	baril 
pagbabasehan	pag ba base han	base 
pagbagsak	pag bagsak	bagsak
Pagbaha	Pag baha	baha
pagbawalan	pag bawal an	bawal 
pagbibigay	pag bi bigay	bigay
pagbisita	pag bisita	bisita
pagbugso	pag bugso	bugso
pagbuhos	pag buhos	buhos
pagdagsa	pag dagsa	dagsa
pagdami	pag dami	dami
Pagdating	Pag dating	dating
Pagdeclare	Pag declare	declare
paggapang	pag gapang	gapang
pagguho	pag guho	guho
paghahanda	pag ha handa	handa
paghandaan	pag handa an	handa 
paghinto	pag hinto	hinto
paghupa	pag hupa	hupa
pagiging	pa gi ging	ging
pagkabaliw	pag ka baliw	baliw
pagkain	pag kain	kain
pagkaipon	pagka ipon	ipon
pagkakadakip	pagka ka dakip	dakip
pagkakagat	pagka kagat	kagat
pagkakakilanlan	pagka ka kila n la n	kila 
pagkakaroon	pagka ka roon	roon
pagkakataon	pagka ka taon	taon
pagkalaerto	pagka alaerto	alaerto
pagkalagnat	pagka lagnat	lagnat
pagkamatay	pagka matay	matay
Pagkaraang	Pagka <r>aan g	<r>aan 
pagkasawi	pagka sawi	sawi
pagkasira	pagka sira	sira
pagkatalo	pagka talo	talo
Pagkatapos	Pagka tapos	tapos
pagkubkob	pag kubkob	kubkob
pagkuha	pag kuha	kuha
paglaganap	pag laganap	laganap
paglalayag	pag la layag	layag
pagligtas	pag ligtas	ligtas
paglilinis	pag li linis	linis
paglindol	pag lindol	lindol
pagluto	pag luto	luto
PAGMAMALABIS	PAG MA MA LABIS	LABIS
Pagmimina	Pag mi mina	mina
pagmulan	pag mula n	mula 
PAGNANAKAW	PAG NA NAKAW	NAKAW
pagod	pagod	pagod
pagpaliban	pag pa liban	liban
Pagpapalaganap	Pag pa pa laganap	laganap
pagpapalaki	pag pa pa laki	laki
pagpapalibing	pag pa pa libing	libing
pagpapasabog	pag pa pa sabog	sabog
pagpapausok	pag pa pa usok	usok
pagpupulong	pag pu pulong	pulong
pagputok	pag putok	putok
pagragasa	pag ragasa	ragasa
pagsabog	pag sabog	sabog
pagsagip	pag sagip	sagip
PAGSALAKAY	PAG SALAKAY	SALAKAY
Pagsapit	Pag sapit	sapit
pagsibak	pag sibak	sibak
pagsunod	pag sunod	sunod
pagsunog	pag sunog	sunog
pagsuot	pag suot	suot
pagsuplay	pag suplay	suplay
pagsusuri	pag su suri	suri
pagsusuring	pag su suri ng	suri 
pagtaas	pag taas	taas
pagtagas	pag tagas	tagas
pagtagilid	pag tagilid	tagilid
pagtama	pag tama	tama
pagtanggap	pag tanggap	tanggap
pagtanggi	pag tanggi	tanggi
pagtatae	pag ta tae	tae
pagtatanong	pag ta tanong	tanong
pagtatapos	pag ta tapos	tapos
pagtitiyak	pag ti tiyak	tiyak
pagtotroso	pag to troso	troso
pagtulong	pag tulong	tulong
pagwawaldas	pag wa waldas	waldas
pagyanig	pag yanig	yanig
pahalagahan	pa halaga han	halaga 
pahayag	pa hayag	hayag
pahayagan	pa hayag an	hayag 
pahina	pahina	pahina
pahinain	pa hina in	hina 
paketadong	paket a do ng	paket 
pakikipag-ugnayan	pa ki ki pag - ugnay an	ugnay 
palabas	pa labas	labas
palabasin	pa labas in	labas 
palagi	pa lagi	lagi
palalakasin	pa la lakas in	lakas 
Palasyo	Palasyo	Palasyo
palawakin	pa lawak in	lawak 
palengke	palengke	palengke
palibot	pa libot	libot
paligid	paligid	paligid
paliparan	pa lipa<r> an	lipa<r> 
pamahalaan	pamahala an	pamahala 
pamahalaang	pamahala a ng	pamahala 
pamamaga	pa ma maga	maga
pamamagitan	pa ma <m>agitan	<m>agitan
pamamaslang	pa ma <m>aslang	<m>aslang
pamatay	pa ma tay	tay
pamaypay	pa <m>aypay	<m>aypay
pambobomba	pam bo bomba	bomba
pamilihan	pa <m>ili han	<m>ili 
pamilya	pamilya	pamilya
pamilyang	pamilya ng	pamilya 
pampang	pampang	pampang
pampubliko	pam publiko	publiko
Pampublikong	Pam publiko ng	publiko 
pamunas	p am unas	p unas
pana-nakit	pan a - <n>akit	<n>akit
PANAGINIP	PANAGINIP	PANAGINIP
panahon	panahon	panahon
panaklolo	pa <n>aklolo	<n>aklolo
Panaklolo	Pa <n>aklolo	<n>aklolo
pananakot	pan a <n>akot	<n>akot
pananalasa	pa na nalasa	nalasa
pananim	pa <n>anim	<n>anim
panawagan	pan awag an	awag 
Panayam	Panayam	ayam
pang	pang	pang
pang-ayos	pang - ayos	ayos
pang-emerhensya	pang - emerhensya	emerhensya
pang-soccer	pang - soccer	soccer
pangalan	pangalan	pangalan
pangalawa	pan <g>alawa	<g>alawa
Pangalawang	Pan <g>alawa ng	<g>alawa 
pangamba	pa ngamba	ngamba
pangambang	pa ngamba ng	ngamba 
pangangailangan	pa nga <ng>ailangan	<ng>ailangan
panganib	pa nganib	nganib
Panginoon	Panginoon	ginoon
pangkagipitang	pang ka gipit an g	gipit 
pangkat	pangkat	pangkat
pangmedikal	pang medik al	medik
pangtulong	pang tulong	tulong
Pangulo	Pang ulo	ulo
Pangulong	Pang ulo ng	ulo 
pangunahing	pang una hin g	una 
pangwalo	pang walo	walo
pangyayari	pang ya yari	yari
Panibagong	Pan i bago ng	bago 
panig	panig	panig
paningin	pa <n>ingin	<n>ingin
paninisi	pan i <n>isi	<n>isi
panlabas	pan labas	labas
panlalawigan	pan lalawigan	lalawigan
panloloko	pan lo loko	loko
Pansamantalang	Pan samantala ng	samantala 
pansariling	pan sarili ng	sarili 
pansinin	pansin in	pansin 
panulukan	pan ul<u>k an	ul<u>k 
papaano	pa paano	paano
papalaot	pa pa laot	laot
papalapit	pa pa lapit	lapit
papalit	pa palit	palit
papangalanang	pa pangalan an g	pangalan 
papasok	pa pasok	pasok
papauwi	pa pa uwi	uwi
papuntang	pa punta ng	punta 
paputok	pa putok	putok
para	para	para
paraan	paraan	paraan
PARALELISMO	PARALEL ISMO	PARALEL
Parang	Para ng	Para 
Parehas	Parehas	Parehas
parin	parin	parin
parotektahan	parotek ta han	parotek
partikular	partikular	partikular
pasado	pasado	pasado
pasahero	pasahero	pasahero
Pasalamat	Pa salamat	salamat
Pasan	Pasan	Pasan
pasasabugin	pa sa sab<u>g in	sab<u>g 
paso	paso	paso
PASOK	PASOK	PASOK
pasyente	pasyente	pasyente
patag	patag	patag
patay	patay	patay
pati	pati	pati
patuloy	pa tuloy	tuloy
patungo	pa tungo	tungo
patungong	pa tungo ng	tungo 
Paulit-ulit	Pa ulit - ulit	ulit
pawang	pawang	pawang
pawis	pawis	pawis
payo	payo	payo
peligro	peligro	peligro
pelikula	pelikula	pelikula
pera	pera	pera
PERANG	PERA NG	PERA
pero	pero	pero
PERSONIPIKASYON	PERSONIPIKA SYON	PERSONIPIKA 
Pgbgyan	Pg bgyan	bgyan
pidal	pidal	pidal
piliing	pilii ng	pilii 
Pilipinong	Pilipino ng	Pilipino 
Pinagbaba-wal	Pinag ba ba-wal	ba-wal
pinagbabawalan	pinag ba bawal an	bawal 
Pinagbawalan	Pinag bawal an	bawal 
pinagdalhang	pinag dalhan g	dalhan 
pinagkukunan	pinag ku ku<n>a n	ku<n>a 
pinagkukutaan	p in ag ku kuta an	kuta 
pinagtitiwalaan	pinag ti tiwala an	tiwala 
Pinahihintulutan	Pina hi hintul<u>t an	hintul<u>t 
pinaka	pinaka	pinaka
pinakabagong	pinaka bago ng	bago 
pinakamabigat	pinaka ma bigat	bigat
pinakamabisang	pinaka ma bisa ng	bisa 
Pinakamalakas	Pinaka ma lakas	lakas
pinakamalalang	pinaka ma lala ng	lala 
pinakamaraming	pinaka ma <r>ami ng	<r>ami 
pinakamataas	pinaka ma taas	taas
pinakamataong	pinaka ma tao ng	tao 
Pinakamatindi	Pinaka ma tindi	tindi
pinakamatinding	pinaka ma tindi ng	tindi 
pinakamatinding-tinamaan	pinaka ma tindi ng - t in ama an	tindi t ama 
pinalampas	p in a lampas	lampas
pinalikas	p in a likas	likas
pinalubog	p in a lubog	lubog
pinangalanan	p in a ngalan an	ngalan 
pinaniwalaan	p in aniwala an	p aniwala 
Pinaniwalaan	P in aniwala an	P aniwala 
pinapaalalahanan	p in a pa alala han an	p alala
pinasok	p in asok	p asok
pinauwi	p in a uwi	p uwi
pinayagan	p in ayag an	p ayag 
pinayuhan	p in ay<u> han	p ay<u> 
pinoproblemanyo	pi no problema nyo	problema
pinsala	pinsala	pinsala
pinsalanag	pinsala nag	pinsala
pinto	pinto	pinto
PINUNTAHAN	P IN UNTA HAN	P UNTA
Pinunto	P in unto	P unto
pipilitin	pi pilit in	pilit 
‎Pito	‎Pito	‎Pito
pito	pito	pito
pitong	pito ng	pito 
planong	plano ng	plano 
planta	planta	planta
plato	plato	plato
po	po	po
Poblacion	Poblacion	Poblacion
Polillo	Polillo	Polillo
pong	po ng	po 
pook	pook	pook
poong	poon g	poon 
Posible	Posible	Posible
posibleng	posible ng	posible 
poste	poste	poste
pra	pra	pra
praang	praan g	praan 
pres	pres	pres
pribadong	pribado ng	pribado 
probinsiya	probinsiya	probinsiya
probinsya	probinsya	probinsya
probinsyal	probinsya l	probinsy
problema	problema	problema
produksiyon	produk siyon	produk
produkto	produkto	produkto
proyekto	proyekto	proyekto
prutas	prutas	prutas
publiko	publik o	publik
puksain	puksa in	puksa 
pulis	pulis	pulis
pulisya	pulis ya	pulis
pulos	pulos	pulos
pumalaot	p um a laot	laot
pumalo	p um alo	p alo
pumapagitna	p um a pa gitna	gitna
pumasok	p um asok	p asok
pumatay	p um atay	p atay
Pumugang	P um uga ng	P uga 
pumunta	p um unta	p unta
puno	puno	puno
punong-kahoy	puno ng - kahoy	puno kahoy
punongkahoy	puno ng kahoy	puno kahoy
punto	punto	punto
pupukaw	pu pukaw	pukaw
Purok	Purok	Purok
puso	puso	puso
puwede	puwede	puwede
Puwedeng	Puwede ng	Puwede 
puwersa	puwersa	puwersa
pwedeng	pwede ng	pwede 
radar	radar	radar
ramdam	ramdam	ramdam
reaksyon	reak syon	reak 
rebeldeng	rebelde ng	rebelde 
rebelyon	rebel yon	rebel
rehimeng	rehimen g	rehimen 
rehiyon	rehiyon	rehiyon
rehiyonal	rehiyon al	rehiyon l
rekonstruksyon	re konstruk syon	konstruk 
residente	residente	residente
responsable	responsable	responsable
resulta	resulta	resulta
RETORIKAL	RETORIK AL	RETORIK
retrato	retrato	retrato
rin	rin	rin
ring	rin g	rin 
rito	rito	rito
riyan	<r>iyan	<r>iyan
rumesponde	r um esponde	r esponde
ruta	ruta	ruta
Sa	Sa	Sa
sa'yo	sa 'yo	yo
Saan	Saan	Saan
Sabado	Sabado	Sabado
Sabi	Sabi	Sabi
sabihin	sabi hin	sabi 
sagabal	sagabal	sagabal
sahig	sahig	sahig
saka	saka	saka
sakahan	saka han	saka 
sakaling	sakali ng	sakali 
sakay	sakay	sakay
sakit	sakit	sakit
saklolo	saklolo	saklolo
sakop	sakop	sakop
sakristiya	sakristiya	sakristiya
Saksi	Saksi	Saksi
Sakuna	Sakuna	Sakuna
sakunang	sakuna ng	sakuna 
salakayin	salakay in	salakay 
Salamat	Salamat	Salamat
Salin	Salin	Salin
Saliw	Saliw	Saliw
sama	sama	sama
Samak	Samak	Samak
Samantalang	Samantala ng	Samantala 
samin	s amin	amin
sana	sana	sana
sanang	sana ng	sana 
sanay	sanay	sanay
sandali	san dali	dali
Sanga	Sanga	Sanga
sanggol	sanggol	sanggol
sanhi	sanhi	sanhi
sanlibong	san libo ng	libo 
SANTO	SANTO	SANTO
sapagkat	sapagkat	sapagkat
sapatos	sapatos	sapatos
sapitin	sapit in	sapit 
sapul	sapul	sapul
sarado	sara do	sara
sarap	sarap	sarap
sariling	sarili ng	sarili 
sasabihin	sa sabi hin	sabi
sasakyan	sa sakyan	sakyan
sasakyang-dagat	sa sakyan g - dagat	sakyan dagat
sau	sa u	u
segundo	segundo	segundo
sekretarya	sekretarya	sekretarya
semento	semento	semento
sentimetro	sentimetro	sentimetro
sentro	sentro	sentro
senyales	senyales	senyales
serye	serye	serye
si	si	si
sibilyang	sibilyan g	sibilyan 
sigla	sigla	sigla
siguro	siguro	siguro
sigurong	siguro ng	siguro 
sikaping	sikap in g	sikap 
Sila	Sila	Sila
silang	sila ng	sila 
silangan	silang an	silang 
silangang	silang an g	silang 
silid-aralan	silid - aral an	silid - aral 
simbahan	simba han	simba 
simula	si mula	si mula
sina	sina	sina
sinabi	s in abi	s abi
sinabing	s in abi ng	s abi 
sinagot	s in agot	s agot
sinalakay	s in alakay	s alakay
sinalanta	s in alanta	s alanta
sinasabi	s in a sabi	sabi 
sinasabing	s in a sabi ng	sabi 
sinasapubliko	s in a sa publiko	publiko
sinaunang	sina una ng	una 
SINEKDOKI	SINEKDOKI	SINEKDOKI
singaw	singaw	singaw
Sinira	S in ira	S ira
Sinisi	S in isi	S isi
sinisilang	s in i silang	silang
sinisilip	s in i silip	silip
Sinisisi	S in i sisi	sisi
Sino	Sino	Sino
sinoman	sino man	sino
SINTAX	SINTAX	SINTAX
sintomas	sintomas	sintomas
sinundan	s in und an	s und 
sinuspende	s in uspende	s uspende
Sinusuri	S in u suri	suri
sipon	sipon	sipon
sisihan	sisi han	sisi 
sisihin	sisi  hin	sisi 
sisikat	si sikat	sikat
sistema	sistema	sistema
Sitio	Sitio	Sitio
sitwasyon	sitwasyon	sitwasyon
siya	siya	siya
siya’y 	siya ’y	siya
siyam	siyam	siyam
Siyang	Siya ng	Siya 
Siyudad	Siyudad	Siyudad
Sobrang	Sobra ng	Sobra 
solusyon	solusyon	solusyon
srili	srili	srili
subalit	subali t	subali 
sugatan	sugat an	sugat 
Sugo	Sugo	Sugo
sumabog	s um abog	s abog
sumaklolo	s um aklolo	s aklolo
sumipa	s um ipa	s ipa
sundalong	sundalo ng	sundalo 
sunog	sunog	sunog
Sunog-kilay	Sunog - kilay	Sunog  kilay
sunugin	sun<u>g in	sun<u>g 
suplay	suplay	suplay
suportang	suporta ng	suporta 
suso	suso	suso
suspendido	suspendi do	suspendi 
susundin	su sundin	sundin
susunod	su sunod	sunod
Sya	Sya	Sya
syo	s yo	yo
taas	taas	taas
taga-Iloilo	taga - Iloilo	Iloilo
taga-PAGASA	taga - PAGASA	PAGASA
taga-roon	taga - <r>oon	<r>oon
tagaligtas	taga ligtas	ligtas
tagapagligtas	taga pag ligtas	ligtas
Tagapagmana	Taga pag mana	mana
tagapagsalita	taga pag salita	salita
tagas	tagas	tagas
Taglay	Taglay	Taglay
tahanan	tahanan	tahanan
tahimik	tahimik	tahimik
takbo	takbo	takbo
taktika	taktika	taktika
tala	tala	tala
talaan	tala an	tala 
talaga	talaga	talaga
talagang	talaga ng	talaga 
talampakan	talampakan	talampakan
talo	talo	talo
TAMA	TAMA	TAMA
tamaan	tama an	tama 
tamang	tama ng	tama 
Tamo	Tamo	Tamo
tanggapan	tanggap an	tanggap 
tanghali	tanghali	tanghali
tanging	tangi ng	tangi 
Tanglaw	Tanglaw	Tanglaw
taniman	tanim an	tanim 
tanod	tanod	tanod
TANONG	TANONG	TANONG
tao	tao	tao
taon	taon	taon
taong	tao ng	tao 
Tapang	Tapang	Tapang
target	target	target
tatama	ta tama	tama
tatamarin	ta tama<r> in	tama<r> 
tatanggap	ta tanggap	tanggap
tatawagin	ta tawag in	tawag 
tatlo	tatlo	tatlo
tatlong	tatlo ng	tatlo 
Tatlumpung	Tatl<u> <m>pu ng	Tatl<u> 
taumbayan	ta<u> <m> bayan	ta<u> bayan
taunang	ta<u>n a ng	ta<u>n  
tayo	tayo	tayo
TAYUTAY	TAYUTAY	TAYUTAY
Telangana	Telangana	Telangana
telepono	telepono	telepono
temperatura	temperatura	temperatura
teritoryo	teritoryo	teritoryo
teroristang	teror ista ng	teror 
tigil	tigil	tigil
tigil-pasada	tigil - pasada	tigil pasada
tila	tila	tila
timba	timba	timba
timbangan	timbang an	timbang 
timbog	timbog	timbog
timog	timog	timog
timog-silangan	timog - silangan	timog silangan
Tinamaan	T in ama an	T ama 
Tinambangan	T in ambang an	T ambang 
tinamong	t in amo ng	t amo 
tinangay	t in angay	t angay
tinanggal	t in anggal	t anggal
tinatahak	t in a tahak	tahak
tinatarget	ti na target	target
Tinatayang	T in a taya ng	taya 
tinatayang	t in a taya ng	taya 
tindi	tindi	tindi
tinesting	t in est ing	t est
tingin	tingin	tingin
TINGNAN	TINGN AN	TINGN
tinodas	t in odas	t odas
Tinukoy	T in ukoy	T ukoy
tinutuluyan	t in u tul<u>y an	tul<u>y 
tipong	tipo ng	tipo 
Tito	Tito	Tito
tiwala	tiwala	tiwala
Tiyak	Tiyak	Tiyak
Todas	Todas	Todas
trahedya	trahedya	trahedya
transportasyon	transporta syon	transporta 
trapiko	trapik o	trapik
tren	tren	tren
tropikal	tropik al	tropik
tsaka	tsaka	tsaka
Tsk	Tsk	Tsk
tsu	tsu	tsu
tubig	tubig	tubig
tubig-baha	tubig - baha	tubig baha
tubig-dagat	tubig - dagat	tubig  dagat
tuhod	tuhod	tuhod
tulad	tulad	tulad
tulay	tulay	tulay
tulog	tulog	tulog
tulong	tulong	tulong
Tuloy	Tuloy	Tuloy
tuluy-tuloy	tuluy-tuloy	tuluy-tuloy
tuluyang	tul<u>y an g	tul<u>y
tumaas	t um aas	t aas
Tumagal	T um agal	T agal
Tumagilid	T um a gilid	gilid
tumakbo	t um akbo	t akbo
Tumama	T um ama	T ama
tumangay	t um angay	t angay
tumataas	t um a taas	taas
tumatagas	t um a tagas	tagas
tumatama	t um a tama	tama
tumatas	t um atas	t atas
Tumawag	T um awag	T awag
tumugon	t um ugon	t ugon
tumulong	t um ulong	t ulong
tumutulo	t um u tulo	tulo
tunay	tunay	tunay
tungkol	tungkol	tungkol
tuparin	tupa<r> in	tupa<r> 
turista	turista	turista
turuan	tur<u> an	tur<u> 
tustado	tusta do	tusta
TUSTADONG	TUSTA DO NG	TUSTA 
tutol	tutol	tutol
tutugon	tu tugon	tugon
tutulad	tu tulad	tulad
Tutulong	Tu tulong	tulong
tutuloy	tu tuloy	tuloy
tuwing	tuwing	tuwing
tuyong	tuyo ng	tuyo 
ubo	ubo	ubo
Ubod	Ubod	Ubod
ugong	ugong	ugong
ukol	ukol	ukol
ulan	ulan	ulan
Ulat	Ulat	Ulat
uli	uli	uli
umaasa	um a asa	asa
umabot	um abot	abot
umaga	um aga	aga
Umakyat	Um akyat	akyat
umano	um ano	ano
umano'y	um ano 'y	ano
umatras	um atras	atras
umulan	um ulan	ulan
umuulan	um u ulan	ulan
un	un	un
una	una	una
Unang	Una ng	Una 
Unang-una	Una ng - una	una
ung	ung	ung
Unibersidad	Unibersidad	Unibersidad
uniporme	uniporme	uniporme
unos	unos	unos
unti-unti	unti - unti	unti
upang	upang	upang
uri	uri	uri
usapin	usap in	usap 
Usero	Usero	Usero
utak	utak	utak
utas	utas	utas
uusad	u usad	usad
uuuy	uu uy	uy
wag	wag	wag
wala	wala	wala
walang	wala ng	wala 
walo	walo	walo
walong	walo ng	walo 
wari’y	wari ’y	wari 
Washi	Washi	Washi
wikang	wika ng	wika 
winasak	w in asak	w asak
yaman	yaman	yaman
yan	yan	yan
yumanig	y um anig	y anig
YUN	YUN	YUN
yung	yung	yung
