token	segmentation	root
abandonado	a band on ad o	band
abarca	a barc a	barc
abogado	abogad o	abogad
abombada	a bomb ad a	bomb
abordan	a bord an	bord
abrazo	abraz o	abraz
abren	abr en	abr
Abril	Abril	Abril
abrió	abr ió	abr
abrir	abr ir	abr
absoluta	ab solut a	solut
abusadores	abus ador es	abus
abuso	abus o	abus
abusos	abus o s	abus
acaba	acab a	acab
acaban	acab an	acab
acabo	acab o	acab
acaso	acaso	acaso
acatan	acat an	acat
acatarla	acat ar la	acat
acción	ac ción	ac
aceite	aceite	aceite
aceptaron	acept aron	acept
aceptó	acept ó	acept
acerca	a cerca	cerca
acero	acer o	acer
acompañaron	a compañ aron	compañ
acordar	acord ar	acord
acres	acre s	acre
actividades	act iv idad es	act
activistas	act iv ista s	act
activos	act iv o s	act
acto	act o	act
acuerdo	ac<ue>rd o	ac<ue>rd
acuestan	ac<ue>st an	ac<ue>st
acumulan	a cumul an	cumul
acusaciones	acus acion es	acus
acusado	acus ad o	acus
acusados	acus ad o s	acus
acusar	acus ar	acus
acusó	acus ó	acus
adecuado	a decu ad o	decu
adelante	a delante	delante
adentrarse	a dentr ar se	dentr
administración	ad ministr ación	ministr
administren	ad ministr en	minist
adolescentes	adolescente s	adolescente
adoptó	adopt ó	adop
adquirir	ad quir ir	quir
advertencia	advert enci a	advert
advirtió	adv<i>rt ió	adv<i>rt
Aérea	Aére a	Aére a
aéreo	aére o	aére o
Aerolíneas	Aero líne a s	Aero línea
afectada	afect ad a	afect
afectadas	afect ad a s	afect
afectados	afect ad o s	afect
afectaron	afect aron	afect
afectó	afect ó	afect
afgano	afgan o	afgan
afirman	afirm an	afirm
Afortunadamente	A fortun ad a mente	fortun
afuera	a fuera	fuera
agarre	a garre	garre
agencias	ag enci a s	ag
agrario	agr ari o	agr
agregó	agreg ó	agreg
agua	agu a	agu
aguas	agu a s	agu
ahí	ahí	ahí
ahorrados	ahorr ad o s	ahorr
ahorro	ahorr o	ahorr
AIRES	AIRE S	AIRE
aislamiento	aisl amient o	aisl
ajenas	ajen a s	ajen
ajenos	ajen o s	ajen
alcance	alcan<c>e	alcan<c>e
alcohólicas	alcohól ic a s	alcohól
alegaron	a leg aron	leg
alejado	a lej ad o	lej
alejó	a lej ó	lej
alemanes	aleman es	aleman
aleta	alet a	alet
álgido	álgid o	álgid
alguien	alguien	alguien
algun	algun	algun
alguno	algun o	algun
alimentaria	aliment ari a	aliment
allegados	alleg ad o s	alleg
alli	alli	alli
Alrededor	Alrededor	Alrededor
alude	alud e	alud
AMARILLENTAS	AMARILL ENT A S	AMARILL
ambas	amb a s	amb 
ambiental	ambient al	ambient
ámbito	ámbit o	ámbit
amenazado	amenaz ad o	amenaz
Americanista	Americ an ista	Americ
amigos	amig o s	amig
amnistías	amnistí a s	amnistí
amo	am o	am
amoladores	amol ador es	amol
amoldazar	a moldaz ar	moldaz
amonio	amoni o	amoni
amplia	ampli a	ampli
ampliamente	ampli amente	ampli
amplios	ampli o s	ampli
añádale	añád a le	añád 
añadieron	añad ieron	añad
Añadió	Añad ió	Añad
analizar	analiz ar	analiz
anaranjado	a naranj ad o	naranj
andino	and in o	and
Animo	Anim o	Anim
ánimo	ánim o	ánim
aniversario	aniversari o	aniversari
año	añ o	añ
anoche	a noche	noche
anonima	anonim a	anonim
Ante	Ante	Ante
antemano	ante mano	mano
anteriores	ant erior es	ant
Antes	Antes	Antes
antiguo	antigu o	antigu
antiterroristas	anti terr or ista s	terr
antojos	antoj o s	antoj
anulando	anul ando	anul
anunciada	anunci ad a	anunci
apaleados	a pale ad o s	pale 
aparato	aparat o	aparat
aparatos	aparat o s	aparat
aparecieron	a parec ieron	parec
apareció	a pare ció	pare
Aparentemente	A parente mente	parente
apartamentos	apartament o s	apartament
apego	a peg o	apeg
apenas	a penas	penas
apertura	apertur a	apertur
apocalipsis	apocalipsis	apocalipsis
apolítico	a polític o	polític
apostando	apost ando	apost
Apoyando	Apoy ando	Apoy
apoyar	apoy ar	apoy
apoyarán	apoy arán	apoy
aprehender	aprehend er	aprehend
aprobado	a prob ad o	prob
aproximaba	a proxim aba	proxim
aproximadamente	a proxim ad a mente	proxim
Aprueban	A pr<ue>b an	A pr<ue>b
apunta	a punt a	punt
AQUI	AQUI	AQUI
Aquí	Aquí	Aquí
árabe	árabe	árabe
arcas	arc a s	arc
archivados	archiv ad o s	archiv
arcos	arc o s	arc
arde	ard e	ard
áreas	áre a s	áre
argumento	argument o	argument
Armadas	Arm ad a s	Arm
armado	arm ad o	arm
armador	arm ador	arm
armando	arm ando	arm
armas	arm a s	arm
armo	arm o	arm
arrasadas	a rras ad a s	rras
arrasado	a rras ad o	rras
arrasaron	a rras aron	rras
arrastrados	a rrastr ad o s	rrastr
arrestado	arrest ad o	arrest
arrestados	arrest ad o s	arrest
arrestaron	arrest aron	arrest
arribar	arrib ar	arrib
asaltaban	a salt aban	salt
Asamblea	Asamble a	Asamble
ascendieron	ascend ieron	ascend
asco	asc o	asc
asegurar	a segur ar	segur
Aseguró	A segur ó	segur
asesina	asesin a	asesin
asesinan	asesin an	asesin
asesores	asesor es	asesor
aseveración	a sever ación	sever
asociación	a soci ación	soci
aspecto	aspect o	aspect
asquerosos	as<q>u eros o s	as<q>u
asunto	asunt o	asunt
Asuntos	Asunt o s	Asunt
asustan	a sust an	sust
atacantes	atac ante s	atac
atacaron	atac aron	atac
atendidos	atend id o s	atend
atentados	atent ad o s	atent
aterrizaban	a terr iz aban	terr
aterrizar	a terr iz ar	terr
atípico	a típic o	típic
ATLETA	ATLETA	ATLETA
atrear	atre ar	atre
atroces	atro<c> es	atro<c>
atropello	atropell o	atropell
AUDIO	AUDIO	AUDIO
aumento	aument o	aument
aun	aun	aun
aunque	aunque	aunque
Australiano	Australi an o	Australi
automóvil	auto móvil	móvil
automóviles	auto móvil es	móvil
autor	autor	autor
avance	avan<c> e	avan<c>
Avión	Avión	Avión
avispa	avisp a	avisp
ayuda	ayud a	ayud
ayudarían	ayud arían	ayud
ayude	ayud e	ayud
ayuden	ayud en	ayud
ayudo	ayud o	ayud
azotada	azot ad a	azot
azotadas	azot ad a s	azot
azotó	azot ó	azot
bailaron	bail aron	bail
bajos	baj o s	baj
BALACERA	BAL A CER A	BAL
balas	bal a s	bal
balostres	balostr es	balostr
banano	banan o	banan
bancos	banc o s	banc
banda	band a	band
bandas	band a s	band
BANDOLERISMO	BANDOL ER ISM O	BANDOL
barrera	barrer a	barrer
Barrio	Barri o	Barri
básicos	básic o s	básic
bastante	bast ante	bast
bebidas	beb id a s	beb
bebieron	beb ieron	beb
beneficio	benefici o	benefici
beneficios	benefici o s	benefici
bicicleta	bi cicl et a	cicl
bien	bien	bien
Bienvenido	Bien ven id o	ven
blanca	blanc a	blanc
blanco	blanc o	blanc
bloque	bloque	bloque
bloqueada	bloque ad a	bloque
boludos	bol ud o s	bol
bombas	bomb a s	bomb
borron	borr on	borr
boxeador	boxe ador	boxe
brazilero	brazil er o	brazil
brigada	brig ad a	brig
brindando	brind ando	brind
brindar	brind ar	brind
brindarles	brind ar les	brind
brochas	broch a s	broch
broma	brom a	brom
bronca	bronc a	bronc
bronce	bronce	bronce
buena	buen a	buen
bueno	buen o	buen
buenos	buen o s	buen
buscaba	busc aba	busc
buscamos	busc amos	busc
buscando	busc ando	busc
buscó	busc ó	busc
caballos	caball o s	caball
cabezas	cabez a s	cabez
cabo	cab o	cab
cagan	cag an	cag
caído	ca íd o	ca
calculo	calcul o	calcul
cálculo	cálcul o	cálcul
cálculos	cálcul o s	cálcul
calificado	cal ific ad o	cal
calle	calle	calle
calles	calle s	calle
Cámara	Cámar a	Cámar
cámaras	cámar a s	cámar
camas	cam a s	cam
cambio	cambi o	cambi
caminaron	camin aron	camin
camión	camión	camión
campaña	campañ a	campañ
CAMPESINOS	CAMP ESIN O S	CAMP
Campos	Camp o s	Camp
canal	canal	canal
cancela	cancel a	cancel
cancelados	cancel ad o s	cancel
canceló	cancel ó	cancel
cáncer	cáncer	cáncer
canciller	cancill er	cancill
canciones	cancion es	cancion
candidatura	candidat ur a	candidat
Cantar	Cant ar	Cant
canten	cant en	cant
Cantos	Cant o s	Cant
capacitados	capacit ad o s	capacit
capitalismo	capital ism o	capital
capitalista	capital ista	capital
capitalistas	capital ista s	capital
capitán	capitán	capitán
capturados	captur ad o s	captur
cara	car a	car
carajo	caraj o	caraj
cárcel	cárcel	cárcel
carceles	carcel es	carcel
cárceles	cárcel es	cárcel
carece	carec e	carec
cargado	carg ad o	carg
cargados	carg ad o s	carg
cargo	carg o	carg
cargos	carg o s	carg
caribeña	carib eñ a	carib
Caribenos	Carib en o s	Carib
caro	car o	car
caros	car o s	car
carrera	carrer a	carrer
carrona	carron a	carron
carta	cart a	cart
casa	cas a	cas
Casi	Casi	Casi
casos	cas o s	cas
castigar	castig ar	castig
castigo	castig o	castig
castrista	castr ista	castr
castro	castr o	castr
castros	castr o s	castr
católicos	católic o s	católic
Cauchero	Cauch er o	Cauch
cayeron	ca yeron	ca
cazadores	caz ador es	caz
célula	célul a	célul
centímetros	centí metr o s	metr
centrado	centr ad o	centr
centroamericanos	centr o americ an o s	americ
centros	centr o s	centr
cercana	cerc an a	cerc
cercanas	cerc an a s	cerc
cercano	cerc an o	cerc
certeza	cert ez a	cert
charlatanes	charlatan es	charlatan
chepo	chepo	chepo
cheque	cheque	cheque
chicharron	chicharr on	chicharr
chileno	chil en o	chil
chino	chin o	chin
chófer	chófer	chófer
choque	choque	choque
choreo	chore o	chore
cierre	c<ie>rr e	c<ie>rr
ciertas	ciert a s	ciert
cierto	ciert o	ciert
cifra	cifr a	cifr
cinco	cinco	cinco
cirujano	cirujan o	cirujan
clamidia	clamidi a	clamidi
clandestina	clandestin a	clandestin
clandestinas	clandestin a s	clandestin
Claro	Clar o	Clar
club	club	club
clubes	club es	club
coincidieron	coincid ieron	coincid
COJAS	CO<J> AS	CO<J>
coje	coj e	coj
cola	col a	col
colector	colec tor	colec
colera	coler a	coler
colocada	coloc ada	coloc
colocas	coloc as	coloc 
Colombianos	Colombi an o s	Colombi
Combate	Combat e	Combat
combatiente	combat iente	combat
combatir	combat ir	combat
comentario	coment ari o	coment
comenzar	comenz ar	comenz
comenzó	comenz ó	comenz
comerciados	comerci ad o s	comerci
comerciar	comerci ar	comerci
comienzo	com<ie>nz o	com<ie>nz
comite	comite	comite
Cómo	Cómo	Cómo
comparar	compar ar	compar
comparte	compart e	compart
compás	compás	compás
compensar	compens ar	compens
completado	complet ad o	complet
complicado	complic ad o	complic
cómplice	cómplice	cómplice
compraban	compr aban	compr
comprado	compr ad o	compr
compradores	compr ador es	compr
comprados	compr ad o s	compr
comprarlos	compr ar los	compr
comprarse	compr ar se	compr
compro	compr o	compr
comprobadores	com prob ador es	prob
comprometerse	com promet er se	promet
compromiso	com promis o	promis
Común	Común	Común
comunicación	comunic ación	comunic
comunicado	comunic ad o	comunic
comunismo	comun ism o	comun
comunista	comun ista	comun
comunistas	comun ista s	comun
con	con	con
concentracion	con centr acion	centr
concentramos	con centr amos	centr
concierto	conciert o	conciert
concluida	con clu id a	clu
condenado	conden ad o	conden
condenados	conden ad o s	conden
condenarlo	conden ar lo	conden
condenas	conden a s	conden
condición	condi ción	condi
confesión	confes ión	confes
confianza	con fi anz a	fi
confirmado	con firm ad o	firm
confirmó	con firm ó	firm
conflictiva	conflict iv a	conflict
conformar	con form ar	form
conforme	con form e	form
congreso	congres o	congres
conmemoró	con memor ó	memor
CONMIGO	CON MIGO	MIGO
conocen	conoc en	conoc
conocí	conoc í	conoc
conocida	conoc id a	conoc
conocieron	conoc ieron	conoc
conquistas	conquist a s	conquist
consideraba	consider aba	consider
considerada	consider ad a	consider
consideran	consid eran	consid
consideró	consider ó	consider
consigna	consign a	consign
consigo	con sigo	sigo
conspiraciones	conspir acion es	conspir
conspirar	conspir ar	conspir
constante	constante	constante
constituyen	con stitu yen	stitu
consumado	consum ad o	consum
consume	consum e	consum e
contaminar	contamin ar	contamin
contarlo	cont ar lo	cont
contempla	contempl a	contempl
Contestar	Contest ar	Contest
CONTESTES	CONTEST ES	CONTEST
continuaban	continu aban	continu
continúan	continú an	continú
continuaremos	continu aremos	continu
continuaron	continu aron	continu
contra	contra	contra
contrajeron	contra<j> eron	contra<j>
contraparte	contra parte	parte
contratar	contrat ar	contrat
contratistas	contrat ista s	contrat
contribuye	con tribu ye	tribu
contribuyeron	con tribu yeron	tribu
control	control	control
controlado	control ad o	control
conversar	convers ar	convers
convictos	convict o s	convict
convocadas	con voc ad a s	voc
coordina	co ordin a	ordin
coordinación	co ordin ación	ordin
copar	cop ar	cop
corazón	corazón	corazón
cordillera	cordiller a	cordiller
corresponde	co rrespond e	rrespond
corrían	corr ían	corr
corrupción	co rrup ción	rrup
corte	corte	corte
Cortenles	Cort en les	Cort
cortos	cort o s	cort
cosas	cos a s	cos
costa	cost a	cost
costarricense	cost a rric ense	cost
costeras	cost er a s	cost
costeros	cost er o s	cost
costos	cost o s	cost
creada	cre ad a	cre
creado	cre ad o	cre
crean	cre an	cre
CREANDO	CRE ANDO	CRE
crearon	cre aron	cre
crecida	crec id a	crec
creciendo	crec iend o	crec
crecimiento	crec imient o	crec
credibilidad	cred ibil idad	cred
Crédito	Crédit o	Crédit
cree	cre e	cre
creer	cre er	cre
creerte	cre er te	cre
creés	cre és	cre
creó	cre ó	cre
creyeron	cre yeron	cre
crimen	crimen	crimen
crímenes	crímen es	crímen
criminal	crimin al	crimin
criminales	crimin al es	crimin
criminalización	crimin al iz ación	crimin
crisis	crisis	crisis
criticada	critic ad a	critic
críticas	crític a s	crític
cual	cual	cual
Cuando	Cuando	Cuando
cuantos	cuant o s	cuant
Cuatro	Cuatro	Cuatro
cubana	cub an a	cub
Cubano	Cub an o	Cub
Cubanos	Cub an o s	Cub
Cubita	Cub it a	Cub 
cuentas	c<ue>nt as	c<ue>nt
cuerpo	cuerp o	cuerp
cuerpos	cuerp o s	cuerp 
cuesta	c<ue>st a	c<ue>st
cueste	c<ue>st e	c<ue>st
cuestión	cuestión	cuestión
cuestionó	cuestion ó	cuestion
culpa	culp a	culp
culpar	culp ar	culp
cumplan	cumpl an	cumpl
cumplimiento	cumpl imient o	cumpl
cumplir	cumpl ir	cumpl
cuna	cun a	cun
Curo	Cur o	Cur
curso	curs o	curs
da	d a	d
DADO	D AD O	D
dama	dam a	dam
Damnificados	Damn ific ad o s	Damn
dan	d an	d
dando	d ando	d
DAÑO	DAÑ O	DAÑ
daños	dañ o s	dañ
DAR	D AR	D
DARLE	D AR LE	D
debatido	debat id o	debat
debe	deb e	deb
deber	deb er	deb
debía	deb ía	deb
débil	débil	débil
década	déc ad a	déc ad
decide	decid e	decid
decidió	decid ió	decid
décimas	déc im a s	déc
décimo	déc im o	déc
decir	dec ir	dec
decirle	dec ir le	dec
decisiones	deci sion es	deci
declaraciones	declar acion es	declar
declarado	declar ad o	declar
Declaran	Decl aran	Decl
declarar	declar ar	declar
decomisado	de comis ad o	comis
Decreta	Decret a	Decret
dedica	dedic a	dedic
defectos	defect o s	defect
defendido	defend id o	defend
defienden	def<ie>nd en	def<ie>nd
defiendes	def<ie>nd es	def<ie>nd
define	defin e	defin
deja	dej a	dej
dejadas	dej ad a s	dej
dejado	dej ad o	dej
dejan	dej an	dej
dejando	dej ando	dej
dejar	dej ar	dej
dejará	dej ará	dej
dejaras	dej aras	dej
dejas	dej as	dej
deje	dej e	dej
dejo	dej o	dej
dejó	dej ó	dej
del	d el	el
delincuencia	delincu enci a	delincu
demócrata	demócrata	demócrata
demoraron	demor aron	demor
demosle	d emos le	d
demuestra	de m<ue>str a	de m<ue>str
den	d en	d
DENTRO	DENTRO	DENTRO
denuncia	denunci a	denunci
denuncias	denunci a s	denunci
denunció	denun ció	denun
departamento	departament o	departament
deportes	deporte s	deporte
depósito	depósito	depósito
depósitos	depósit o s	depósit
derechos	derech o s	derech
derivados	deriv ad o s	deriv
derrocar	derroc ar	derroc
derrota	derrot a	derrot
desaparecidas	des a parec id a s	parec
desaparecidos	des a parec id o s	parec
desapareció	des a parec ió	parec
Desarrollo	Desarroll o	Desarroll
desató	des at ó	at
desbaratados	des barat ad o s	barat
descomposición	des compo si ción	compo
desconoce	des conoc e	conoc
Desconocimiento	Des conoc imient o	conoc
descubren	des cubr en	cubr
desdenado	desden ad o	desden
desesperacion	des esper acion	esper
desmadrados	des madr ad o s	madr
desmembrado	des membr ad o	membr
despenalización	des pen al iz ación	pen
desplazadas	des plaz ad a s	plaz
desplomarse	des plom ar se	desplom
desprecio	des preci o	preci
después	después	después
destacó	destac ó	destac
destino	destin o	destin
destruirla	de stru ir la	stru
desventaja	des ventaj a	ventaj
desvincular	des vincul ar	vincul
detalle	detalle	detalle
detalles	detalle s	detalle
Detalló	Detall ó	Detall
detectados	detect ad o s	detect
detenciones	de ten cion es	ten
detenidos	de ten id o s	ten
determinar	de termin ar	termin
detonar	de ton ar	ton
Deuda	Deud a	Deud
devora	de vor a	vor
día	día	día
diarrea	diarre a	diarre
dias	dia s	dia
días	día s	día
DICE	D<I>C E	D<I>C
dices	d<i>c es	d<i>c
dictadas	dict ad a s	dict
dieron	d ieron	d
diez	diez	diez
diezmó	diez m ó	diez
diferentes	diferente s	diferente
difícil	difícil	difícil
difundió	di fund ió	fund
digan	d<i> gan	d<i>
digo	d<i> go	d<i>
dijo	d<i> jo	d<i>
dilapidaron	dilapid aron	dilapid
diminutivo	di minut iv o	minut
dinamitar	dinamit ar	dinamit
dinero	diner o	diner
Diputado	Diput ad o	Diput
directa	direct a	direct
directiva	direct iv a	direct
directo	direct o	direct
diría	d iría	d iría
dirigencia	dirig enci a	dirig
dirigente	dirig ente	dirig
dirigentes	dirig ente s	dirig
dirigidas	dirig id a s	dirig
dirigido	dirig id o	dirig
dirigieron	dirig ieron	dirig
dirigió	dirig ió	dirig
disco	disc o	disc o
discriminar	dis crimin ar	crimin
disculparse	dis culp ar se	culp
discutió	discut ió	discut
discutir	discut ir	discut
disfrazar	dis fraz ar	fraz
disolverlo	di solv er lo	solv
disparadas	dis par ad a s	par
dispone	dis pon e	pon
dispuesto	dis p<ue>st o	p<ue>st
dista	dist a	dist
distintos	distint o s	distint
distraidos	distra id o s	distra
distribuía	dis tribu ía	tribu
distribuirse	distribu ir se	tribu
distrito	distrit o	distrit
divide	divid e	divid
divididas	divid id a s	divid
divisibles	divis ible s	divi
división	divi sión	divi
DIVISIONES	DIVI SION ES	DIVI
divulgaron	divulg aron	divulg
divulgó	divulg ó	divulg
Doble	Doble	Doble
doctores	doctor es	doctor
dolar	dolar	dolar
dominante	domin ante	domin
domingo	doming o	doming
Donde	Donde	Donde
dorada	dor ad a	dor
Dos	Dos	Dos
droga	drog a	drog
duda	dud a	dud
dulce	dulce	dulce
duplicaron	duplic aron	duplic
duras	dur a s	dur
Económica	Económ ic a	Económ
economicos	econom ic o s	econom
Ecuatoriano	Ecuator ian o	Ecuator
edad	edad	edad
edificio	edifici o	edifici
edificios	edifici o s	edifici
efectiva	efect iv a	efect
efectos	efect o s	efect
efectuadas	efectu ad a s	efectu
efectuar	efectu ar	efectu
eficaces	efica<c> es	efica<c>
ejecución	ejecu ción	ejecu
ejecutado	ejecut ad o	ejecut
electricidad	electric idad	electric
elemento	element o	element
elementos	element o s	element
elevado	elev ad o	elev
elevó	elev ó	elev
ella	ella	ella
embajada	embaj ad a	embaj
embajadas	embaj ad a s	embaj
embarazos	embaraz o s	embaraz
emboscaron	em bosc aron	bosc
emergencia	emerg enci a	emerg
emergentes	emerg ente s	emerg
empezó	empez ó	empez
emprendieron	em prend ieron	prend
emprendimiento	em prend imient o	prend
empresarios	empres ari o s	empres
empuja	empuj a	empuj
En	En	En
encabezar	en cabez ar	cabez
encapuchados	en capuch ad o s	capuch
encarcelado	en carcel ad o	carcel
encarcelados	en carcel ad o s	carcel
encargada	en carg ad a	carg
encargados	en carg ad o s	carg
encima	encima	encima
encontrándole	encontr ándo le	encontr
encontrar	encontr ar	encontr
encontré	encontr é	encontr
encontró	encontr ó	encontr
encuentran	enc<ue>ntr an	enc<ue>ntr
encuentras	enc<ue>ntr as	enc<ue>ntr
encuestados	en cuest ad o s	cuest
endose	en dos e	dos
enemigos	enemig o s	enemig
enero	ener o	ener
enfermedad	enferm edad	enferm
enfrentan	en frent an	frent
enfrente	en frente	frente
enjuiciar	en juici ar	juici
enjuiciarán	en juici arán	juici
enormes	enorme s	enorme
ensayo	ensay o	ensay
entendiendo	entend iend o	entend
enterado	enter ad o	enter
enteraron	enter aron	enter
enterrados	en terr ad o s	terr
entiende	ent<ie>nd e	ent<ie>nd
entienden	ent<ie>nd en	ent<ie>nd
entiendo	ent<ie>nd o	ent<ie>nd
entrada	entr ad a	entr
entran	entr an	entr
entrar	entr ar	entr
entregará	entreg ará	entreg
entregue	entreg<u> e	entreg<u>
entrenamiento	entren amient o	entren
entró	entr ó	entr
enviar	envi ar	envi
enviaron	envi aron	envi
epidemia	epidemi a	epidemi
Equipo	Equip o	Equip
equipos	equip o s	equip
errores	error es	error
escapaba	escap aba	escap
escapar	escap ar	escap
escapo	escap o	escap
escasa	escas a	escas
esclarecer	es clar ec er	clar
escombros	escombr o s	escombr
escuchaba	escuch aba	escuch
escuchar	escuch ar	escuch
Escudero	Escud er o	Escud
escuela	escuel a	escuel
esforzaban	es forz aban	forz
Especial	Especial	Especial
especialistas	especial ista s	especial
específico	específ ic o	específ
especulativo	especulat iv o	especulat
esperaba	esper aba	esper
esperamos	esper amos	esper
esperándolo	esper ándo lo	esper
esperanza	esper anz a	esper
esperanzados	esper anz ad o s	esper
esperanzas	esper anz a s	esper
esposo	espos o	espos
Está	Est á	Est
Estaba	Est aba	Est
estábamos	est ábamos	est
estaban	est aban	est
estabilidad	estabil idad	estabil
estable	estable	estable
estación	est ación	est
estado	est ad o	est
Estados	Est ad o s	Est
Estadounidenses	Est ad o un id ense s	Est
estalinista	estalin ista	estalin
estalló	estall ó	estall
estamos	est amos	est
ESTAN	EST AN	EST
ESTÁN	EST ÁN	EST
estancada	estanc ad a	estanc
estancadas	estanc ad a s	estanc
estará	est ará	est
estarian	est arian	est
Este	Este	Este
esten	est en	est
esterilizada	esteril iz ad a	esteril
estimación	estim ación	estim
Estimada	Estim ad a	Estim
estimado	estim ad o	estim
estirando	estir ando	estir
estrelló	estrell ó	estrell
ESTUDIANTES	ESTUDI ANTE S	ESTUDI
Estudiarán	Estudi arán	Estudi
estupefaciente	estup efaci ente	estup
estupidez	estupid ez	estupid
estuvieron	est uvieron	est
etapa	etap a	etap
europea	europe a	europe
europeo	europe o	europe
evacuadas	evacu ad a s	evacu
evadir	evad ir	evad
evalúan	evalú an	evalú
evita	evit a	evit
examine	examin e	examin
excarcelado	ex carcel ad o	carcel
exigen	exig en	exig
Exigimos	Exig imos	Exig
exigir	exig ir	exig
exiliado	exili ad o	exili
existían	exist ían	exist
existido	exist id o	exist
éxito	éxit o	éxit
explicaciones	explic acion es	explic
explicando	explic ando	explic
explicandole	explic ando le	explic
explicó	explic ó	explic
explorar	explor ar	explor
explosion	ex plo sion	plo
explosiones	ex plo sion es	plo
expresado	expres ad o	expres
expresarse	expres ar se	expres
extradición	ex tradi ción	tradi
extraditado	ex tradi tad o	tradi
extrañaran	extrañ aran	extrañ
extranjeros	extranjer o s	extranjer
extremistas	extrem ista s	extrem
fabrica	fabric a	fabric
fabricas	fabric a s	fabric
facil	facil	facil
fajan	faj an	faj
fallaron	fall aron	fall
Fallece	Fallec e	Fallec
fallecido	fallec id o	fallec
fallecidos	fallec id o s	fallec
fallido	fall id o	fall
fallidos	fall id o s	fall
fallo	fall o	fall
falsas	fals a s	fals
falso	fals o	fals
falsos	fals o s	fals
FAMA	FAM A	FAM
familiarizada	famili ar iz ad a	famili
familias	famili a s	famili
fea	fe a	fe
fecha	fech a	fech
felices	feli<c> es	feli<c>
Ferroviaria	Ferro via ri a	via
fertilizante	fertil iz ante	fertil
fertilizantes	fertil iz ante s	fertil
fervor	fervor	fervor
fiesta	fiest a	fiest
filtrado	filtr ad o	filtr
Fin	Fin	Fin
final	fin al	fin
finalizaría	fin al iz aría	fin
Financiero	Financ ier o	Financ
financieron	financ ieron	financ
financieros	financ ier o s	financ
fines	fin es	fin
firme	firm e	firm
flechas	flech a s	flech
florecer	flor ec er	flor
fomentar	foment ar	foment
fondo	fond o	fond
forma	form a	form
formacion	form acion	form
formuladas	formul ad a s	formul
foro	for o	for
forradores	forr ador es	forr
fortalecer	forta lec er	forta
forzada	forz ad a	forz
forzado	forz ad o	forz
foto	foto	foto
fotógrafo	fotógraf o	fotógraf
fotos	foto s	foto
fracaso	fracas o	fracas
frágil	frágil	frágil
frágiles	frágil es	frágil
francés	francés	francés
franceses	frances es	frances
frecuente	frecu ente	frecuente
frente	frente	frente
frontera	fronter a	fronter
fruto	frut o	frut
Fue	Fu e	Fu
fué	fu é	fu
Fuente	Fuente	Fuente
fueran	fu eran	fu
Fuertes	Fuerte s	Fuerte
Fuerzas	Fuerz a s	Fuerz
fuesen	fu esen	fu
fugitivos	fugit iv o s	fugit
fundamentar	fundament ar	fundament
funden	fund en	fund
fuselaje	fusel aje	fusel
futbol	futbol	futbol
futuro	futur o	futur
galletas	gallet a s	gallet
gama	gam a	gam
ganar	gan ar	gan
gane	gan e	gan
ganó	gan ó	gan
garantias	garanti a s	garanti
gastan	gast an	gast
gaste	gast e	gast
gastó	gast ó	gast
gastos	gast o s	gast
gatos	gat o s	gat
genera	gener a	gener
generalizado	general iz ad o	general
generalizados	general iz ad o s	general
generalmente	general mente	general
GENERAR	GENER AR	GENER
gente	gente	gente
gigantescas	gigant esc a s	gigant
girar	gir ar	gir
gitanas	gitan a s	gitan
gobernadores	gobern ador es	gobern
golpe	golpe	golpe
golpeadores	golpe ador es	golpe
golpiza	golp iz a	golp
gorda	gord a	gord
gozan	goz an	goz
gracias	graci a s	graci
grado	grad o	grad
GRANDE	GRANDE	GRANDE
grandes	grande s	grande
granitos	granit o s	granit
gratis	gratis	gratis
graves	grave s	grave
gripe	gripe	gripe
gritando	grit ando	grit
grupo	grup o	grup
grupos	grup o s	grup
guardaba	guard aba	guard
Guardacostas	Guard a cost a s	Guard
Guerra	Guerr a	Guerr
guerrilla	guerr ill a	guerr
gustaria	gust aria	gust
Ha	H a	H
haberle	hab er le	hab
haberles	hab er les	hab
habia	hab ia	hab
habian	hab ian	hab
habían	hab ían	hab
habitantes	habit ante s	habit
Habla	Habl a	Habl
hablar	habl ar	habl
hablaremos	habl aremos	habl
hablas	habl as	habl
hables	habl es	habl
habló	habl ó	habl
habran	hab ran	hab
habria	hab ria	hab
Habría	Hab ría	Hab
hace	hac e	hac
hacer	hac er	hac
hacerlo	hac er lo	hac
haces	hac es	hac
haciendo	hac iendo	hac
haga	ha ga	ha
hagamos	ha gamos	ha
hallado	hall ad o	hall
halló	hall ó	hall
HAMBRUNA	HAMBR UN A	HAMBR
hará	ha rá	ha
harán	ha rán	ha
haría	ha ría	ha
has	h as	h
hasta	hasta	hasta
HAY	HAY	HAY
hecho	h<e>ch o	h<e>ch
hechos	h<e>ch o s	h<e>ch
heladas	hel ad a s	hel
herida	her id a	her
heridas	her id a s	her
herido	her id o	her
Heridos	Her id o s	Her
herir	her ir	her
Hermanas	Herman a s	Herman
hermano	herman o	herman
hicieron	h<i>c ieron	h<i>c
Higiene	Higiene	Higiene
hijos	hij o s	hij
historia	histori a	histori
HOMBRE	HOMBRE	HOMBRE
homenaje	homenaje	homenaje
Homenajes	Homenaje s	Homenaje
hondureña	hondur eñ a	hondur
horribles	horrible s	horrible
hospitalizadas	hospital iz ad a s	hospital
hostilidades	hostil idad es	hostil
Hoteles	Hotel es	Hotel
hoy	hoy	hoy
Hubo	H<u>b o	H<u>b
huevos	huev o s	huev
Humor	Humor	Humor
hunda	hund a	hund
huracán	huracán	huracán
idea	ide a	ide
idearon	ide aron	ide
ideas	ide a s	ide
ido	id o	id
ilegal	i legal	legal
ilícitas	i lícit a s	lícit
ilimitadas	i limit ad a s	limit
imperio	imperi o	imperi
imploró	im plor ó	plor
importa	im port a	port
importe	im port e	port
IMPOSIBLE	IM POS IBLE	POS
imprescriptibles	im prescript ible s	prescript
Imprimir	Im prim ir	prim
Impunidad	Im pun idad	pun
Inaceptable	In acept able	acept
incalculable	in calcul able	calcul
incluido	in clu id o	clu
incluye	in clu ye	clu
incluyendo	in clu yendo	clu
incluyeron	in clu yeron	clu
incrementar	in crement ar	crement
indeclinable	in declin able	declin
indemniza	in demn iz a	demn
indica	indic a	indic
índice	índice	índice
Indicó	Indic ó	Indic
Indios	Indi o s	Indi
Indudablemente	In dud able mente	dud
indultos	indult o s	indult
industrial	industri al	industri
industrias	industri a s	industri
infamia	in fam i a	fam
inferior	infer ior	infer
infiel	in fiel	fiel
influenza	influenz a	influenz
informado	in form ad o	form
informaron	in form aron	form
Infórmate	In fórm a te	fórm
informe	in form e	form
inicialmente	inicial mente	inicial
iniciar	inici ar	inici
inmediata	inmediat a	inmediat
inmenso	inmens o	inmens
inmigración	in migr ación	migr
inocente	i noc ente	noc
inseguridad	in segur idad	segur
insensibilidad	in sensibil idad	sensibil
instaba	inst aba	inst
Institutores	Institut or es	Institut
instrumento	instrument o	instrument
instruyera	instru yera	instru
intelectual	inte lect ual	lect
inteligencia	inte lig enci a	lig
intenciones	intencion es	intencion
Intenso	Intens o	Intens
intento	inten to	inten
intercepciones	inter cep cion es	cep
interceptadas	inter cep tad a s	cep
interés	interés	interés
interminables	in termin able s	termin
internacional	inter nacion al	nacion
internacionales	inter nacion al es	nacion
Internos	Intern o s	Intern
interrogantes	inte rrog ant es	rrog
intestinos	intestin o s	intestin
intrépidos	intrépid o s	intrépid
inundarse	inund ar se	inund
inventó	inven tó	inven
investigado	in vestig ad o	vestig
investigadores	in vestig ador es	vestig
investigar	in vestig ar	vestig
invitamos	in vit amos	vit
involucradas	in volucr ad a s	volucr
involucran	in volucr an	volucr
ir	ir	ir
iraní	iran í	iran
islámica	islám ic a	islám
israelí	israel í	israel
Israelitas	Israel it a s	Israel
jamas	jamas	jamas
japonés	japon és	japon
Jefe	Jefe	Jefe
jefes	jefe s	jefe
joder	jod er	jod
jodido	jod id o	jod
jornada	jorn ad a	jorn
joven	joven	joven
jóvenes	j<ó>ven es	j<ó>ven
juego	j<ue>g o	j<ue>g
jugar	jug ar	jug
julio	juli o	juli
junio	juni o	juni
junto	junt o	junt
justificar	just ific ar	just
juzgar	juzg ar	juzg
kilogramos	kil o gram o s	gram
kilos	kil o s	kil
kirchneristas	kirchner ista s	kirchner
laborales	labor al es	labor
laburo	labur o	labur
laderas	lader a s	lader
langosta	langost a	langost
lanzamiento	lanz amient o	lanz
lanzar	lanz ar	lanz
latina	latin a	latin
latinos	latin o s	latin
lavado	lav ad o	lav
lealtad	leal tad	leal
Lechería	Lech erí a	Lech
Legajos	Legaj o s	Legaj
legisladores	legis lador es	legis
lejano	lej an o	lej
lejos	lejos	lejos
leon	leon	leon
lesbianas	lesbian a s	lesbian
lesionado	lesion ad o	lesion
letrada	letr ad a	letr
levantamos	levant amos	levant
leyó	le yó	le
Liberación	Liber ación	Liber
liberadas	liber ad a s	liber
liberal	liber al	liber
liberamos	liber amos	liber
Libertadores	Libert ador es	Libert
libras	libr a s	libr
libre	libre	libre
libro	libr o	libr
liderazgo	lider azg o	lider
líneas	líne a s	líne
listo	list o	list
llamadas	llam ad a s	llam
llamarlos	llam ar los	llam
llame	llam e	llam
llegar	lleg ar	lleg
Llegó	Lleg ó	Lleg
llegue	llegu e	llegu
Llegué	Llegu é	Llegu
llena	llen a	llen
llenas	llen a s	llen
llevaba	llev aba	llev
Llevados	Llev ad o s	Llev
LLEVAN	LLEV AN	LLEV
llevando	llev ando	llev
llevandolos	llev ando los	llev
llevandosela	llev ando se la	llev
llevó	llev ó	llev
llover	llov er	llov
local	loc al	loc
localidades	loc al idad es	loc
locura	loc ur a	loc
lógica	lógic a	lógic
Logramos	Logr amos	Logr
logran	logr an	logr
logró	logr ó	logr
LOS	LOS	LOS
lucha	luch a	luch
luchando	luch ando	luch
luchar	luch ar	luch
lucraron	lucr aron	lucr
Luego	Luego	Luego
lugar	lugar	lugar
Luna	Lun a	Lun
lunes	lunes	lunes
luto	lut o	lut
madre	madre	madre
madrugada	madrug ad a	madrug
madurando	madur ando	madur
magnifica	magn ific a	magn
mago	mag o	mag
Mal	Mal	Mal
MALA	MAL A	MAL
malagueña	malagu eñ a	malagu
malo	mal o	mal
mandaba	mand aba	mand
mando	mand o	mand
manejador	manej ador	manej
manejarse	manej ar se	manej
Manejo	Manej o	Manej
manera	maner a	maner
MANGO	MANG O	MANG
manías	maní a s	maní
manifestantes	manifest ante s	manifest
mantener	man ten er	ten
mantengan	man ten gan	ten
mantiene	man t<ie>n e	t<ie>n
MANTO	MANT O	MANT
Mar	Mar	Mar
Maravilla	Maravill a	Maravill
marcada	marc ad a	marc
marcha	march a	march
marihuana	marihuan a	marihuan
Marina	Marin a	Marin
martes	martes	martes
MARTILLO	MARTILL O	MARTILL
Más	Más	Más
masacre	masacre	masacre
masticar	mastic ar	mastic
matar	mat ar	mat
mataron	mat aron	mat
maten	mat en	mat
material	materi al	materi
Matina	Matin a	Matin
Mato	Mat o	Mat
máxima	máxim a	máxim
mayo	may o	may
Mayor	Mayor	Mayor
mayormente	mayor mente	mayor
medalla	medall a	medall
medallistas	medall ista s	medall
Media	Medi a	Medi
médico	médic o	médic
medidas	med id a s	med
medios	medi o s	medi
mejor	mejor	mejor
mejoramiento	mejor amient o	mejor
memoria	memori a	memori
mencionadas	mencion ad a s	mencion
menguaron	mengu aron	mengu
meningitis	mening itis	mening
menor	menor	menor
menores	menor es	menor
MENOS	MENOS	MENOS
Mensaje	Mensaje	Mensaje
mentira	mentir a	mentir
meramente	mer amente	mer
mercaderia	mercad eri a	mercad
Mercado	Mercad o	Mercad
mercados	mercad o s	mercad
merced	merced	merced
mercurio	mercuri o	mercuri
merecen	merec en	merec
meteorológico	meteor ológ ic o	meteor
meter	met er	met
meterse	met er se	met
metodos	metod o s	metod
Metropolitana	Metropoli tan a	Metropoli
metros	metr o s	metr
mexicano	mexic an o	mexic
miembros	miembr o s	miembr
mientras	mientras	mientras
mil	mil	mil
milicianas	mili cian a s	mili
militar	milit ar	milit
millares	millar es	millar
millones	millon es	millon
ministro	ministr o	ministr
mintieron	m<i>nt ieron	m<i>nt
MINUTO	MINUT O	MINUT
mira	mir a	mir
miserable	miser able	miser
MISERIA	MISERI A	MISERI
MISMAS	MISM A S	MISM
mismos	mism o s	mism
modelo	model o	model
moderna	modern a	modern
mono	mon o	mon
Montaña	Montañ a	Montañ
monzónicas	monzónic a s	monzónic
morir	mor ir	mor
mortales	mort al es	mort
morteros	morter o s	morter
mosquitos	mos<q>u it o s	mos<q>u
moverse	mov er se	mov
movida	mov id a	mov
móvil	móvil	móvil
mucha	much a	much
muchachito	muchach it o	muchach
Muchas	Much a s	Much
muchísimo	much ísim o	much
mucho	much o	much
muchos	much o s	much
Muera	M<ue>r a	M<ue>r
mueran	m<ue>r an	m<ue>r
Muere	M<ue>r e	M<ue>r
Mueren	M<ue>r en	M<ue>r
muertas	m<ue>rt a s	m<ue>rt
muestras	m<ue>str a s	m<ue>str
mujeres	mujer es	mujer
multas	mult a s	mult
MUNDIAL	MUND IAL	MUND
mundo	mund o	mund
murieran	m<u>r ieran	m<u>r
murieron	m<u>r ieron	m<u>r
murió	m<u>r ió	m<u>r
musulmán	musulm án	musulm
mutilaron	mutil aron	mutil
mutual	mutu al	mutu
nacientes	nac iente s	nac
nació	nac ió	nac
Nación	Nación	Nación
Naciones	Nacion es	Nacion
Nada	Nada	Nada
Nadie	Nadie	Nadie
Naranjo	Naranj o	Naranj
narcotraficantes	narco trafic ante s	trafic
Narro	Narr o	Narr
naturales	natural es	natural
navales	naval es	naval
nazista	naz ista	naz
necesaria	neces ari a	neces
necesario	neces ari o	neces
necesarios	neces ari o s	neces
necesidades	neces idad es	neces
necesita	necesit a	necesit
Necesitamos	Necesit amos	Necesit
necesitan	necesit an	necesit
negado	neg ad o	neg
negarle	neg ar le	neg
negarse	neg ar se	neg
negocio	negoci o	negoci
negocios	negoci o s	negoci
negro	negr o	negr
nena	nen a	nen
neoyorquinos	neo yor<q>u in o s	yor<q>u
nesesidades	neses idad es	neses
neutralizan	neutr al iz an	neutr
nevado	nev ad o	nev
ni	ni	ni
nicaragüense	nicarag<ü> ense	nicarag<ü>
niebla	niebl a	niebl
niega	n<ie>g a	n<ie>g
nietos	niet o s	niet
niña	niñ a	niñ
ningún	ningún	ningún
Niño	Niñ o	Niñ
niños	niñ o s	niñ
nitrato	nitrat o	nitrat
nivel	nivel	nivel
no	no	no
nombrados	nombr ad o s	nombr
nombras	nombr a s	nombr
norcoreanos	nor core an o s	core
notificaron	not ific aron	not
noviembre	noviembre	noviembre
novios	novi o s	novi
nucleares	nuclear es	nuclear
NUEVA	NUEV A	NUEV
nuevos	nuev o s	nuev
número	númer o	númer
numerosas	numer os a s	numer
numerosos	numer os o s	numer
nunca	nunca	nunca
obligación	oblig ación	oblig
obligó	oblig ó	oblig
obras	obr a s	obr
obreros	obr er o s	obr
observaron	observ aron	observ
observen	observ en	observ
obstáculos	obstácul o s	obstácul
obstruir	ob stru ir	stru
obtener	ob ten er	ten
Obviamente	Obvi amente	Obvi
ocasionadas	oca sion ad a s	oca
ocasionado	oca sion ad o	oca
Ocho	Ocho	Ocho
ocurrido	ocurr id o	ocurr
Odio	Odi o	Odi
oeste	oeste	oeste
oferta	ofert a	ofert
oficial	oficial	oficial
oficiales	oficial es	oficial
oficialista	oficial ista	oficial
ofrece	ofrec e	ofrec
oigas	oi gas	oi
ojo	oj o	oj
olvidar	olvid ar	olvid
olviden	olvid en	olvid
Once	Once	Once
operan	oper an	oper
opinar	opin ar	opin
opinión	opinión	opinión
opio	opi o	opi
oportunamente	oportun amente	oportun
OPOSITORAS	OPOSIT OR A S	OPOSIT
orales	oral es	oral
orden	orden	orden
ordenanzas	orden anz a s	orden
ordenes	orden e s	orden
ordenó	orden ó	orden
ordinario	ordin ari o	ordin
organisacion	organis acion	organis
organizada	organiz ad a	organiz
organizados	organiz ad o s	organiz
organizó	organiz ó	organiz
orientado	orient ad o	orient
oriental	orient al	orient
oscuridad	oscur idad	oscur
otra	otr a	otr
otras	otr a s	otr
Otro	Otr o	Otr
OTROS	OTR O S	OTR 
oye	o ye	o
padecimiento	padec imient o	padec
paga	pag a	pag
pagados	pag ad o s	pag
pagan	pag an	pag
pagarle	pag ar le	pag
pago	pag o	pag
país	país	país
paises	pais es	pais
paja	paj a	paj
palabras	palabr a s	palabr
palacio	palaci o	palaci
panameña	panam eñ a	panam
papel	papel	papel
para	para	para
paralelo	paralel o	paralel
paralización	paral iz ación	paral
Parece	Parec e	Parec
parecía	parec ía	parec
parecían	parec ían	parec
parecio	parec io	parec
pared	pared	pared
Parque	Parque	Parque
partes	parte s	parte
participantes	particip ante s	particip
participó	particip ó	particip
partida	part id a	part
Partido	Part id o	Part
partir	part ir	part
pasajeros	pasaj er o s	pasaj
pasar	pas ar	pas
pasara	pas ara	pas
pasaría	pas aría	pas
pasaron	pas aron	pas
pase	pas e	pas
paseando	pase ando	pase
Pasen	Pas en	Pas
pasmado	pasm ad o	pasm
Paso	Pas o	Pas
pasos	pas o s	pas
pata	pat a	pat
patata	patat a	patat
Paz	Paz	Paz
pecuarias	pecu ari a s	pecu
pedido	ped id o	ped
pega	peg a	peg
peleando	pele ando	pele
peleas	pele a s	pele
penal	pen al	pen
pendiente	pend iente	pend
pensas	pens as	pens
pequenas	pequen a s	pequen
perdieron	perd ieron	perd
perfecto	perfect o	perfect
periodistas	period ista s	period
periodo	period o	period
período	períod o	períod
permanente	perman ente	perman
permite	permit e	permit
permitió	permit ió	permit
permitir	permit ir	permit
permitiria	permit iria	permit
Pero	Pero	Pero
perpetua	perpetu a	perpetu
perras	perr a s	perr
perro	perr o	perr
perros	perr o s	perr
PERSIGUEN	PER S<I>GU EN	S<I>GU
persiguiendo	per s<i>gu iendo	s<i>gu
persiste	persist e	persist
persisten	persist en	persist
persona	person a	person
peruano	peru an o	peru
pescuesos	pescues o s	pescues
petróleo	petróle o	petróle o
piden	p<i>d en	p<i>d
PIDIENDO	P<I>D IENDO	P<I>D
pie	pie	pie
piedad	pi edad	pi
Piezas	Piez a s	Piez
pinche	pinch e	pinch
pinga	ping a	ping
pingueros	pinguer o s	pinguer
piojos	pioj o s	pioj
pistas	pist a s	pist
plaga	plag a	plag
planeó	plan e ó	plan
planes	plan es	plan
plastica	plastic a	plastic
plástico	plástic o	plástic
plata	plat a	plat
plenamente	plen amente	plen
pleno	plen o	plen
pliegues	pl<ie>gue s	pl<ie>gue
poblados	pobl ad o s	pobl
pobres	pobre s	pobre
poco	poc o	poc
pocos	poc o s	poc
podamos	pod amos	pod
podemos	pod emos	pod
poderoso	poder os o	poder
poderosos	poder os o s	poder
podes	pod es	pod
podía	pod ía	pod
podrá	pod rá	pod
podran	pod ran	pod
podría	pod ría	pod
podrian	pod rian	pod
podridos	p<o>dr id o s	p<o>dr
policiales	polici al es	polici
Policías	Policí a s	Policí
político	polític o	polític
ponele	pon e le	pon
poner	pon er	pon
ponerlos	pon er los	pon
ponerse	pon er se	pon
pongan	pon gan	pon
Ponme	Pon me	Pon
poquito	po<q>u it o	po<q>u
porcentaje	por cent aje	cent
portavoz	port a voz	voz
porte	port e	port
Posada	Pos ad a	Pos
posee	pose e	pose
posesión	pose sión	pose
posible	pos ible	pos
poste	post e	post
POSTEO	POSTE O	POSTE
postes	poste s	poste
Pozo	Poz o	Poz
pozos	poz o s	poz
precedente	pre ced ente	ced
precio	preci o	preci
Prefiero	Pref<ie>r o	Pref<ie>r
preguntarselo	pregunt ar se lo	pregunt
preguntó	pregunt ó	pregunt
preocúpense	pre ocúp en se	ocúp
preparando	prepar ando	prepar
presa	pres a	pres
Presenta	Present a	Present
presentación	present ación	present
presentarse	present ar se	present
PRESIDENTE	PRESID ENTE	PRESID
presisamente	presis amente	presis
presos	pres o s	pres
prestaran	prest aran	prest
presuntamente	presunt amente	presunt
presuntos	presunt o s	presunt
pretextos	pre text o s	text
prevenir	pre ven ir	ven
preventivamente	pre ven tiv amente	ven
previamente	previa mente	previa
Primer	Primer	Primer
primeras	primer a s	primer
Primero	Primer o	Primer
Primeros	Primer o s	Primer
principales	principal es	principal
Príncipe	Príncipe	Príncipe
prisión	prisión	prisión
prisionero	prision er o	prision
prisioneros	prision er o s	prision
privada	priv ad a	priv
problemas	problema s	problema
problematica	problema tic a	problema
probó	prob ó	prob
proceso	proces o	proces
procuración	pro cur ación	cur
produciría	produc iría	produc
productos	product o s	product
progreso	progres o	progres
prohibido	prohib id o	prohib
prometieron	promet ieron	promet
pronunció	pro nunc ió	nunci
propias	propi a s	propi
propiedad	propi edad	propi
propiedades	propi edad es	propi
propio	propi o	propi
propios	propi o s	propi
propone	pro pon e	pon
proporcionaron	pro porcion aron	porcion
proporcionó	pro por cion ó	por
prostitutas	prostitut a s	prostitut
protocolo	protocol o	protocol
provincia	provinci a	provinci
provoca	provoc a	provoc
provocaron	provoc aron	provoc
proximo	proxim o	proxim
pruebas	pr<ue>b as	pr<ue>b
publica	public a	public
Público	Públic o	Públic
pudieran	p<u>d ieran	p<u>d
pudranse	pudr an se	pudr
pueblos	puebl o s	puebl
puedan	p<ue>d an	p<ue>d
Puede	P<ue>d e	P<ue>d
Puedo	P<ue>d o	P<ue>d
puente	puente	puente
puentes	puente s	puente
puerta	puert a	puert
puesto	p<ue>st o	p<ue>st
pulmmones	pulmmon es	pulmmon
puntualizó	puntual iz ó	puntual
putas	put a s	put
Que	Que	Que
QUEDADO	QUED AD O	QUED
quedan	qued an	qued
quedar	qued ar	qued
quedaran	qued aran	qued
quedaron	qued aron	qued
quedó	qued ó	qued
quemas	quem as	quem
querer	quer er	quer
QUERES	QUER ES	QUER
queso	ques o	ques
quien	quien	quien
Quién	Quién	Quién
quiera	qu<ie>r a	qu<ie>r
quieran	qu<ie>r an	qu<ie>r
quiere	qu<ie>r e	qu<ie>r
QUIEREN	QU<IE>R EN	QU<IE>R
quiero	qu<ie>r o	qu<ie>r
quince	quince	quince
quita	quit a	quit
quitate	quit a te	quit
racha	rach a	rach
racismo	ra<c> ism o	ra<c>
radiación	radi ación	radi
rapidez	r<a>pid ez	r<a>pid
ratones	raton es	rat<o>n
razon	razon	razon
razón	razón	razón
razones	razon es	razon
reabrir	re abr ir	abr
reabrirá	re abr irá	abr
reactivos	re act iv o s	act
realizaban	realiz aban	realiz
realización	realiz ación	realiz
realmente	real mente	real
reanuda	re anud a	anud
reanudará	re anud ará	anud
reapertura	re a<p>er tur a	a<p>er
recatan	recat an	recat
rechazaron	rechaz aron	rechaz
reciben	recib en	recib
recibió	recib ió	recib
recién	recién	recién
recientes	rec iente s	rec
reclamarle	re clam ar le	clam
reclusión	re clu sión	clu
recolectores	re colect or es	colect
reconstrucción	re constru cción	constru
recordar	record ar	record
recuerda	rec<ue>rd a	rec<ue>rd
Recuerdan	Rec<ue>rd an	Rec<ue>rd
recuerdo	rec<ue>rd o	rec<ue>rd
recuperación	re cuper ación	cuper
recursos	recurs o s	recurs
red	red	red
Redes	Red es	Red
redujo	re du jo	du
reemplazará	re em plaz ará	plaz
refieres	ref<ie>r es	ref<ie>r
regiones	region es	region
registrado	registr ad o	registr
registrar	registr ar	registr
registren	registr en	registr
regresar	regres ar	regres
rehen	rehen	rehen
relacionadas	re la cion ada s	la
relatos	relat o s	relat
remediaría	re medi aría	medi
remedio	re medi o	medi
remota	re mot a	mot
remoto	re mot o	mot
rendir	rend ir	rend
renunciar	re nunci ar	nunci
reo	re o	re
reos	re o s	re
repetir	re pet ir	pet
REPITO	RE P<I>T O	P<I>T
replicó	re plic ó	plic
representaron	re present aron	present
republicano	republic an o	republic
republicanos	republic an o s	republic
rescate	rescate	rescate
rescatistas	rescat ista s	rescat
residentes	resident es	resident
residuo	residu o	residu
resolución	re solu ción	solu
respaldan	re spald an	spald
Respecto	Respect o	Respect
respeto	respet o	respet
responder	respond er	respond
respondió	respond ió	respond
responsables	respons able s	respons
restantes	rest ante s	restante
restauradores	re staur ador es	staur
resto	rest o	rest
restos	rest o s	rest
resuelto	re s<ue>lt o	s<ue>lt
resulta	result a	result
resultado	result ad o	result 
resultados	result ad o s	result
resultaron	result aron	result
resulto	result o	result
resumen	re sum en	sum
Retiro	Re tir o	tir
retractó	re tract ó	tract
reunión	re un ión	un
reunirán	re un irán	un
reverenda	reverend a	reverend
revisa	re vis a	vis
revista	revist a	revist
Rica	Ric a	Ric
ridicula	ridicul a	ridicul
riesgo	riesg o	riesg
rinde	r<i>nd e	r<i>nd
Rioja	Rioj a	Rioj
robado	rob ad o	rob
robados	rob ad o s	rob
robar	rob ar	rob
roben	rob en	rob
Roja	Roj a	Roj
Rojas	Roj a s	Roj
Rojo	Roj o	Roj
rollado	roll ad o	roll
rompa	romp a	romp
ropa	rop a	rop
ROQUE	ROQUE	ROQUE
rumbo	rumb o	rumb
sabe	sab e	sab
sabian	sab ian	sab
sacaban	sac aban	sac
sacado	sac ad o	sac
saco	sac o	sac
sacudió	sacud ió	sacud
saldo	sald o	sald
sales	sal es	sal
salgamos	sal gamos	sal
salida	sal id a	sal
salio	sal io	sal
salió	sal ió	sal
salmones	salmon es	salmon
salten	salt en	salt
saludable	salud able	salud
Salvador	Salv ador	Salv
sancionar	sancion ar	sancion
sanitaria	sani tari a	sani
SAQUE	SA<Q>U E	SA<Q>U E
sarampión	sarampión	sarampión
sargentos	sargent o s	sargent
sea	s ea	s
secreto	secret o	secret
sectores	sector es	sector
secuestrado	secuestr ad o	secuestr
secuestro	secuestr o	secuestr
sede	sede	sede
sediciosos	sed ici os o s	sed
seguimiento	segu imient o	segu
SEGUIR	SEGU IR	SEGU
Según	Según	Según
segundos	segund o s	segund
seguro	segur o	segur
seguros	segur o s	segur
segurosos	segur os o s	segur
sello	sell o	sell
semana	seman a	seman
senador	senad or	senad
señala	señal a	señal
señalado	señal ad o	señal
señaló	señal ó	señal
senda	send a	send
SENDERISTAS	SENDER IST A S	SENDER
señor	señor	señor
señora	señor a	señor
sentenciados	sentenci ad o s	sentenci
sentido	sent id o	sent
sentirse	sent ir se	sent
separan	separ an	separ
ser	s er	s
será	s erá	s
seran	s eran	s
seria	s eria	s
sería	s ería	s
serian	s erian	s
servicio	servici o	servici
Servicios	Servici o s	Servici
sexuales	sex ual es	sex
si	si	si
sienten	s<ie>nt en	s<ie>nt
SIENTO	S<IE>NT O	S<IE>NT
siete	siete	siete
sifradas	sifr ad a s	sifr
siglo	sigl o	sigl
signo	sign o	sign
sigue	s<i>gu e	s<i>gu
SIGUEN	S<I>GU EN	S<I>GU
siguieron	s<i>gu ieron	s<i>gu
simpatizantes	simpat iz ante s	simpat 
simple	simple	simple
sin	sin	sin
sindicalisados	sindicalis ad o s	sindicalis
sintieron	s<i>nt ieron	s<i>nt
sionismo	sion ism o	sion
sionista	sion ista	sion
sitio	siti o	siti o
Sobre	Sobre	Sobre
sobreviviente	sobre viv iente	viv
sobrevivientes	sobre viv iente s	viv
sobrevivieron	sobre viv ieron	viv
SOBREVIVIR	SOBRE VIV IR	VIV
sociedad	soci edad	soci
socioeconómica	socio económ ic a	económ
socorro	socorr o	socorr
sol	sol	sol
solamente	sol amente	sol
soldados	soldad o s	soldad
Solicitamos	Solicit amos	Solicit
solicitan	solicit an	solicit
solidariza	solidar iz a	solidar
sólo	sól o	sól
Somos	S omos	S
SON	S ON	S
SONIDO	SON ID O	SON
soportar	soport ar	soport
sostenerse	sos ten er se	ten
sosteniendo	sos ten iendo	ten
sostuvo	sos tuv o	tuv
sótano	sótan o	sótan
Su	Su	Su
subalternos	sub altern o s	altern
subida	sub id a	sub
súbita	súbit a	súbit
Sucre	Sucre	Sucre
suficientemente	sufic iente mente	sufic
suficientes	sufic iente s	sufic
sufren	sufr en	sufr
suicidaron	suicid aron	suicid
suicidas	suicid a s	suicid
sumaron	sum aron	sum
sumergió	su merg ió	merg
suministro	su ministr o	ministr
superhéroe	super héro e	héro
supermercado	super mercad o	mercad
supongamos	su pon gamos	pon
Suprema	Suprem a	Suprem
supuestamente	su p<ue>st a mente	p<ue>st
sureña	sur eñ a	sur
surge	surg e	surg
suspender	sus pend er	pend
tal	tal	tal
tales	tal es	tal
taller	taller	taller
también	también	también
TAN	TAN	TAN
tanto	tant o	tant
tarjeta	tarjet a	tarjet
tarjetas	tarjet a s	tarjet
tasa	tas a	tas
TAXIS	TAXI S	TAXI
telefonía	telefon ía	telefon
teléfono	teléfon o	teléfon
teme	tem e	tem
tendencias	tenden cia s	tenden
tendrá	ten drá	ten
tendrán	ten drán	ten
tendrian	ten drian	ten
tenga	ten ga	ten
Tengamos	Ten gamos	Ten
tenía	ten ía	ten
tenientes	ten iente s	ten
terapia	terapi a	terapi
Terminaras	Termin aras	Termin
terreno	terr en o	terr
terrestres	terr estre s	terr
terrible	terr ible	terr
territorio	terr itori o	terr
terror	terr or	terr
TERRORISMO	TERR OR ISM O	TERR
terroristas	terr or ista s	terr
testimonio	testimoni o	testimoni
tiempo	tiemp o	tiemp
Tiendas	Tiend a s	Tiend
TIENE	T<IE>N E	T<IE>N
Tienen	T<ie>n en	T<ie>n
tierras	tierr a s	tierr
tipo	tip o	tip
tiros	tir o s	tir
titular	titul ar	titul
tocan	toc an	toc
tocó	toc ó	toc
todas	tod a s	tod
TODO	TOD O	TOD
Todos	Tod o s	Tod
tomaron	tom aron	tom
topas	top as	top
tópico	tópic o	tópic
torácico	torác ic o	torác
tormenta	torment a	torment
tormentas	torment a s	torment
tornado	torn ad o	torn
torno	torn o	torn
Torres	Torre s	Torre
tortura	tortur a	tortur
tostadores	tost ador es	tost
trabaja	trabaj a	trabaj
trabajaban	trabaj aban	trabaj
trabajan	trabaj an	trabaj
trabajar	trabaj ar	trabaj
trabajará	trabaj ará	trabaj
trabajen	trabaj en	trabaj
TRABAJO	TRABAJ O	TRABAJ
traficar	trafic ar	trafic
trafico	trafic o	trafic
tráfico	tráfic o	tráfic
trago	trago	trago
transcurrido	trans curr ido	curr
transcurso	trans curs o	curs
transportaba	trans port aba	port
Tras	Tras	Tras
trasladados	tras lad ad o s	lad
tratado	trat ad o	trat
tratamos	trat amos	trat
tratar	trat ar	trat
trataría	trat aría	trat
tratarse	trat ar se	trat
traumatismo	trauma tism o	trauma
tregua	tregu a	tregu
tren	tren	tren
trenes	tren es	tren
tres	tres	tres
trescientos	tres cient o s	cient
Tribunal	Tribun al	Tribun
tribunas	tribun a s	tribun
tributo	tribut o	tribut
trillador	trill ador	trill
tripulantes	tripul ante s	tripul
trofeo	trofe o	trofe
tropas	trop a s	trop
tropical	trop ic al	trop
tuberculosis	tuberculosis	tuberculosis
tubo	tub o	tub
tulipán	tulipán	tulipán
Tulipanes	Tulipan es	Tulipan
turismo	tur ism o	tur
turístico	tur ístic o	tur
tuvieron	tuv ieron	tuv
tuviese	tuv iese	tuv
tuvo	tuv o	tuv
ubicado	ubic ad o	ubic
ULTIMA	ULTIM A	ULTIM
última	últim a	últim
ULTIMO	ULTIM O	ULTIM
últimos	últim o s	últim
única	únic a	únic
UNICO	UNIC O	UNIC
únicos	únic o s	únic
Unidad	Un idad	Un
Unidas	Un id a s	Un
unidos	un id o s	un
Uno	Un o	Un
uso	us o	us
Usted	Usted	Usted
utilizar	util iz ar	util
va	v a	v
vacuna	vacun a	vacun
vacunarlo	vacun ar lo	vacun
vagones	vagon es	vagon
vale	val e	val
valores	valor es	valor
Van	V an	V
vanagloriandose	van a glori ando se	glori
vano	van o	van
variar	vari ar	vari
vas	v as	v
vaya	v aya	v
vecinas	vecin a s	vecin
vehículo	vehícul o	vehícul
vehículos	vehícul o s	vehícul
veían	ve ían	ve
vencidos	venc id o s	venc
vendió	vend ió	vend
venezolana	venezol an a	venezol
Venezolanos	Venezol an o s	Venezol
vengo	ven go	ven
venia	ven ia	ven
venta	vent a	vent
ver	v er	v
veran	v eran	v
verdades	verdad es	verdad
veredicto	veredict o	veredict
vestido	vest id o	vest
vez	vez	vez
viaja	viaj a	viaj
viajaba	viaj aba	viaj
viajes	viaje s	viaje
viajó	viaj ó	viaj
vías	vía s	vía
vicepresidente	vice presid ente	presid
víctima	víctima	víctim
Víctimas	Víctima s	Víctim
VÍCTIMAS	VÍCTIMA S	VÍCTIM
vida	vid a	vid
videojuegos	video jueg o s	jueg
videos	vide o s	vide
vídeovigilancia	vídeo vigil anci a	vigil
viejo	viej o	viej
viernes	viernes	viernes
vieron	v ieron	v
vigilados	vigil ad o s	vigil
vigilando	vigil ando	vigil
violar	viol ar	viol
violencia	violenci a	violenci
vira	vir a	vir
virtual	virtu al	virtu
visitantes	visit ante s	visit
visitar	visit ar	visit
vista	vist a	vist
viviendo	viv iendo	viv
vivió	viv ió	viv
voladura	vol adur a	vol
volarán	vol arán	vol
Volcán	Volcán	Volcán
volúmenes	vol<ú>men es	vol<ú>men
voluntarios	volunt ari o s	volunt 
volver	volv er	volv
Volví	Volv í	Volv
Vota	Vot a	Vot
votantes	vot ante s	vot
voto	vot o	vot
VOY	V OY	V
vuelve	v<ue>lv e	v<ue>lv
zapatos	zapat o s	zapat
zona	zon a	zon
