token	segmentation	root
abad	abad	abad
abadi	abadi	abadi
adanya	ada nya	ada
adaptif	adaptif	adaptif
Adegan	Adegan	Adegan
adegan-adegan	adegan - adegan	adegan
adrenalin	adrenalin	adrenalin
agak	agak	agak
Agaknya	Agak nya	Agak
Agama	Agama	Agama
agar	agar	agar
Agustus	Agustus	Agustus
Ahli	Ahli	Ahli
airnya	air nya	air
ajari	ajar i	ajar 
Akhirnya	Akhir nya	Akhir
akibat	akibat	akibat
akses	akses	akses
Aktif	Aktif	Aktif
aktivitasnya	aktivitas nya	aktivitas
aktor-aktor	aktor - aktor	aktor 
akuntabilitas	akunt abilitas	akunt
akuratan	akurat an	akurat
Alam	Alam	Alam
alangkah	alangkah	alangkah
alasan	alas an	alas
alat	alat	alat
aliran	alir an	alir
alun	alun	alun
alur	alur	alur
aman	aman	aman
Amaran	Amar an	Amar
amati	amat i	amat
ambruk	ambruk	ambruk
Anak	Anak	Anak
anaknya	anak nya	anak
analisis	analis is	analis
Anda	Anda	Anda
andai	andai	andai
andal	andal	andal
anggota	anggota	anggota
Angin	Angin	Angin
Angka	Angka	Angka
angkasa	angkasa	angkasa
angkat	angkat	angkat
Anonim	Anonim	Anonim
antar	antar	antar
ANTARA	ANTAR A	ANTARA
antaranya	antara nya	antara
antinyamuk	anti nyamuk	nyamuk
antisipasi	anti sipasi	sipasi
Antrean	Antre an	Antre
Apa	Apa	Apa
apabila	apa bila	bila
Apakah	Apa kah	Apa
apalagi	apa lagi	apa
api	api	api
apik	apik	apik
Aral	Aral	Aral
Arbitrase	Arbitrase	Arbitrase
areal	areal	areal
areanya	area nya	area
Artinya	Arti nya	Arti
Arus	Arus	Arus
asal	asal	asal
asap	asap	asap
aspek	aspek	aspek
Asri	Asri	Asri
Atas	Atas	Atas
atom	atom	atom
awak	awak	awak
awalannya	awalan nya	awalan
awalnya	awal nya	awal
Awan	Awan	Awan
AYO	AYO	AYO
BACA	BACA	BACA
Badai	Badai	Badai
badan	badan	badan
Bagaimana	Bagaimana	Bagaimana
Bagi	Bagi	Bagi
bagian	bagian	bagian
bagian-bagian	bagian - bagian	bagian
Baginya	Bagi nya	Bagi
bagunan	bagun an	bagun
bagus	bagus	bagus
Bahan	Bahan	Bahan
Bahana	Bahana	Bahana
BAHASA	BAHASA	BAHASA
bahaya	bahaya	bahaya
Bahkan	Bahkan	Bahkan
bahwa	bahwa	bahwa
baiknya	baik nya	baik
baku	baku	baku
balik	balik	balik
Bambu	Bambu	Bambu
ban	ban	ban
bandang	bandang	bandang
bangkit	bangkit	bangkit
bangsa	bangsa	bangsa
bangsa-bangsa	bangsa - bangsa	bangsa
bangun	bangun	bangun
bangunan	bangun an	bangun
bangunan-bangunan	bangun an - bangun an	bangun
Banjir	Banjir	Banjir
banjir-longsor	banjir - longsor	banjir - longsor
Bank	Bank	Bank
bantaran	bantar an	bantar
Bantu	Bantu	Bantu
Bantuan	Bantu an	Bantu
banyak	banyak	banyak
banyaknya	banyak nya	banyak
bapak	bapak	bapak
barisan	baris an	baris
Baru	Baru	Baru
baru-baru	baru - baru	baru
basis	basis	basis
batu	batu	batu
batuannya	batu an nya	batu
batubara	batubara	batubara
Bawa	Bawa	Bawa
bayi	bayi	bayi
beban	beban	beban
Beberapa	Be berapa	berapa
beberkan	beber kan	beber
bedah	bedah	bedah
begitu	begitu	begitu
Bekukan	Beku kan	Beku
belakang	belakang	belakang
belakangan	belakang an	belakang
Belasan	Belas an	Belas
beliung	beliung	beliung
belum	belum	belum
benahi	benah i	benah
benar-benar	benar - benar	benar
bencana	bencana	bencana
bendungan	bendung an	bendung
bening	bening	bening
Bentuk	Bentuk	Bentuk
berada	berada	berada
beradaptasi	ber adaptasi	adaptasi
berakhir	ber akhir	akhir
berakibat	ber akibat	akibat
beranjak	ber anjak	anjak
berapa	berapa	berapa
Berapi	Ber api	api
beras	beras	beras
berasal	ber asal	asal
berat	berat	berat
berawal	ber awal	awal
berbagai	ber bagai	bagai
berbasis	ber basis	basis
berbatu	ber batu	batu
berbentuk	ber bentuk	bentuk
berbicara	ber bicara	bicara
berbondong-bondong	ber bondong - bondong	bondong
bercampur	ber campur	campur
bercat	ber cat	cat
berdampak	ber dampak	dampak
berdarah	ber darah	darah
Berdasarkan	Ber dasar kan	dasar
berdaya	ber daya	daya
berdiri	ber diri	diri
berdiskusi	ber diskusi	diskusi
berdoa	ber doa	doa
berfungsi	ber fungsi	fungsi
berganti	ber ganti	ganti
bergulir	ber gulir	gulir
berhamburan	ber hambur an	hambur
Berhasil	Ber hasil	hasil
berhenti	ber henti	henti
Beri	Beri	Beri
Berikan	Beri kan	Beri
beriklim	ber iklim	iklim
Berikut	Ber ikut	ikut
berikutnya	ber ikut nya	ikut
berinvestasi	ber investasi	investasi
Berita	Berita	Berita
berjalan	ber jalan	jalan
berjumlah	ber jumlah	jumlah
berkarung-karung	ber karung - karung	karung
berkeinginan	ber ke ingin an	ingin
berkelok-kelok	ber kelok - kelok	kelok
berkembang	ber kembang	kembang
berkepanjangan	ber ke panjang an	panjang
berkerumun	ber ke rumun	rumun
berkilo-kilo	ber kilo - kilo	kilo
berkontribusi	ber kontribusi	kontribusi
berkoordinasi	ber koordinasi	koordinasi
berkuatan	ber kuat an	kuat
berkumpul	ber kumpul	kumpul
berkunjung	ber kunjung	kunjung
berkurang	ber kurang	kurang
berlalu	ber lalu	lalu
berlangsung	ber langsung	langsung
berlangsungnya	ber langsung nya	langsung
berlantai	ber lantai	lantai
berlari	ber lari	lari
berlayar	ber layar	layar
berlebihan	ber lebih an	lebih
berlinang	ber linang	linang
berlomba	ber lomba	lomba
Berlubang	Ber lubang	lubang
bermanfaat	ber manfaat	manfaat
berperan	ber peran	peran
berpusat	ber pusat	pusat
bersahabat	ber sahabat	sahabat
bersahut-sahutan	ber sahut - sahut an	sahut
bersamaan	ber sama an	sama
bersangkutan	ber sangkut an	sangkut
bersatu	ber satu	satu
bersebelahan	ber se belah an	belah
bersedia	ber sedia	sedia
bersemak	ber semak	semak
bersifat	ber sifat	sifat
Bersih	Bersih	Bersih
berskala	ber skala	skala
berstatus	ber status	status
bersumber	ber sumber	sumber
bertahun-tahun	ber tahun - tahun	tahun
bertindak	ber tindak	tindak
bertingkat	ber tingkat	tingkat
berukuran	ber ukur an	ukur
berulang	ber ulang	ulang
Beruntung	Ber untung	untung
berupa	be rupa	rupa
berusaha	ber usaha	usaha
berusia	ber usia	usia
bervariasi	ber variasi	variasi
berwenang	ber wenang	wenang
berwisata	ber wisata	wisata
besar	besar	besar
besar-besaran	besar - besar an	besar
besaran	besar an	besar
Besarnya	Besar nya	Besar
bestek	bestek	bestek
beterbangan	be terbang an	terbang
biak	biak	biak
biang	biang	biang
Biar	Biar	Biar
biasa	biasa	biasa
biasanya	biasa nya	biasa
bicara	bicara	bicara
bidang	bidang	bidang
Bikin	Bikin	Bikin
bila	bila	bila
bir	bir	bir
bisnis	bisnis	bisnis
bocor	bocor	bocor
Bogem	Bogem	Bogem
bola	bola	bola
bom	bom	bom
Bosan	Bosan	Bosan
botol	botol	botol
buat	buat	buat
buatan	buat an	buat
Budaya	Budaya	Budaya
Bujuk	Bujuk	Bujuk
bukan	bukan	bukan
bukti	bukti	bukti
Buktinya	Bukti nya	Bukti
bulan	bulan	bulan
bulan-bulan	bulan - bulan	bulan
Bumi	Bumi	Bumi
Bundaran	Bundar an	Bundar
Buru	Buru	Buru
Buruh	Buruh	Buruh
buruk	buruk	buruk
Buruknya	Buruk nya	Buruk
Butuh	Butuh	Butuh
Camat	Camat	Camat
canggih	canggih	canggih
Capai	Capai	Capai
catatan	catat an	catat
Catur	Catur	Catur
cedera	cedera	cedera
cek	cek	cek
Cempaka	Cempaka	Cempaka
cenderung	cenderung	cenderung
Center	Center	Center
cepat	cepat	cepat
cetak	cetak	cetak
CINCIN	CINCIN	CINCIN
ciri	ciri	ciri
Coba	Coba	Coba
COBAAN	COBA AN	COBA
Condong	Condong	Condong
contoh	contoh	contoh
Contohnya	Contoh nya	Contoh
corong	corong	corong
Cuaca	Cuaca	Cuaca
cukup	cukup	cukup
cuma	cuma	cuma
curah	curah	curah
curam	curam	curam
dada	dada	dada
daerah	daerah	daerah
Dahsyat	Dahsyat	Dahsyat
dahulu	d ah ulu	d ulu
dalam	dalam	dalam
dalamnya	dalam nya	dalam
Dampak	Dampak	Dampak
Dan	Dan	Dan
dana	dana	dana
dangkal	dangkal	dangkal
dapat	dapat	dapat
darah	darah	darah
Darurat	Darurat	Darurat
dasar	dasar	dasar
dasarnya	dasar nya	dasar
data	data	data
Daulat	Daulat	Daulat
daya	daya	daya
debit	debit	debit
deg-degan	deg - deg an	deg
dekade	dekade	dekade
dekat	dekat	dekat
delapan	delapan	delapan
demikian	demi ki an	demi
dengan	dengan	dengan
dengar	dengar	dengar
depan	depan	depan
depannya	depan nya	depan
Departemen	Departemen	Departemen
derajat	derajat	derajat
derita	derita	derita
Dermaga	Dermaga	Dermaga
desa	desa	desa
desa-desa	desa - desa	desa
Desember	Desember	Desember
destinasi	destinasi	destinasi
deteksi	deteksi	deteksi
detik	detik	detik
Dewa	Dewa	Dewa
dia	dia	dia
diabaikan	di abai kan	abai
diakibatkan	di akibat kan	akibat
diakses	di akses	akses
dialami	di alam i	alam
dialokasikan	di a lokasi kan	lokasi
diam-diam	diam - diam	diam
diambil	di ambil	ambil
dianggap	di anggap	anggap
diangkut	di angkut	angkut
Diantara	Di antara	antara
Diantisipasi	Di anti sipasi	sipasi
diare	diare	diare
diatas	di atas	atas
diatasi	di atas i	atas
dibangun	di bangun	bangun
dibantah	di bantah	bantah
dibantu	di bantu	bantu
dibawa	di bawa	bawa
Dibayangkan	Di bayang kan	bayang
dibentuk	di bentuk	bentuk
diberangkatkan	di ber angkat kan	angkat
diberikan	di beri kan	beri
diberitakan	di berita kan	berita
diberlakukan	di ber laku kan	laku
dibiarkan	di biar kan	biar
dibiayai	di biaya i	biaya
dibongkar	di bongkar	bongkar
dibuat	di buat	buat
dibubar	di bubar	bubar
Dibuka	Di buka	buka
dibuktikan	di bukti kan	bukti
didaulat	di daulat	daulat
didokumentasikan	di dokumen tasi kan	dokumen
diduga	di duga	duga
Dievakuasi	Di evakuasi	evakuasi
difokuskan	di fokus kan	fokus
Digital	Digital	Digital
digunakan	di guna kan	guna
diguncang	di guncang	guncang
dihadapkan	di hadap kan	hadap
dihajar	di hajar	hajar
dihantam	di hantam	hantam
diharap	di harap	harap
Diharapkan	Di harap kan	harap
dihari	di hari	hari
dihiasi	di hias i	hias
dihimpun	di himpun	himpun
dihitung	di hitung	hitung
dihubungi	di hubung i	hubung
diidentifikasi	di identifikasi	identifikasi
diimbau	di imbau	imbau
diinvestasikan	di investasi kan	investasi
diizinkan	di izin kan	izin
dijalan-jalan	di jalan - jalan	jalan
dijatuhkan	di jatuh kan	jatuh
Dijelaskan	Di jelas kan	jelas
dijumpai	di jumpa i	jumpa
Dikarenakan	Di karena kan	karena
Dikebut	Di kebut	kebut
dikejutkan	di kejut kan	kejut
dikelola	di kelola	kelola
dikerjakan	di kerja kan	kerja
Diketahui	Di ke tahu i	tahu
diketemukan	di ke temu kan	temu
dikhawatirkan	di khawatir kan	khawatir
dikirimkan	di kirim kan	kirim
dikit	dikit	dikit
dikonfirmasi	di konfirmasi	konfirmasi
dikunjungi	di kunjung i	kunjung
dilacak	di lacak	lacak
diladang	di ladang	ladang
dilakukan	di laku kan	laku
dilaluinya	di lalu i nya	lalu
dilanda	di landa	landa
dilansir	di lansir	lansir
dilepas	di lepas	lepas
dilepaskan	di lepas kan	lepas
dilestarikan	di lestari kan	lestari
dilokasi	di lokasi	lokasi
diminta	di minta	minta
dimulai	di mulai	mulai
dinamakan	di nama kan	nama
Dinas	Dinas	Dinas
Dinding	Dinding	Dinding
Dini	Dini	Dini
dinilai	di nilai	nilai
dipadamkan	di padam kan	padam
Dipastikan	Di pasti kan	pasti
diperankan	di peran kan	peran
diperantarai	di perantara i	perantara
diperbolehkan	di per boleh kan	boleh
Diperkirakan	Di per kira kan	kira
diperkuat	di per kuat	kuat
diperlukan	di perlu kan	perlu
dipermukaan	di per muka an	muka
diperoleh	di per oleh	oleh
dipersilangan	di per silang an	silang
dipertanyakan	di per tanya kan	tanya
dipimpin	di pimpin	pimpin
dipindahkan	di pindah kan	pindah
diplomatik	diplomatik	diplomatik
dipublikasikan	di publikasi kan	publikasi
diputuskan	di putus kan	putus
dirasakan	di rasa kan	rasa
diratakan	di rata kan	rata
direhabilitasi	di rehabilitasi	rehabilitasi
direkam	di rekam	rekam
Diri	Diri	Diri
dirilis	di rilis	rilis
disajikan	di saji kan	saji
disampaikan	di sampai kan	sampai
disana	di sana	sana
disapu	di sapu	sapu
disebabkan	di sebab kan	sebab
disebut	di sebut	sebut
Diselamatkan	Di selamat kan	selamat
disepanjang	di se panjang	panjang
diserahkan	di serah kan	serah
disertai	di serta i	serta
disetrum	di setrum	setrum
disewakan	di sewa kan	sewa
disiplin	disiplin	disiplin
distribusinya	distribusi nya	distribusi
ditaksir	di taksir	taksir
ditampilkan	di tampil kan	tampil
ditangani	di tangan i	tangan
ditangkap	di tangkap	tangkap
ditarik	di tarik	tarik
ditentukan	di tentu kan	tentu
diterapkan	di terap kan	terap
ditetapkan	di tetap kan	tetap
ditimbulkan	di timbul kan	timbul
ditularkan	di tular kan	tular
Ditunda	Di tunda	tunda
Ditutup	Di tutup	tutup
diucapkan	di ucap kan	ucap
diujung	di ujung	ujung
diungsikan	di ungsi kan	ungsi
divisi	divisi	divisi
divonis	di vonis	vonis
diwaktu-waktu	di waktu - waktu	waktu
doanya	doa nya	doa
dokumentasi	dokumentasi	dokumentasi
dolar	dolar	dolar
Dosen	Dosen	Dosen
dua	dua	dua
Duh	Duh	Duh
duit	duit	duit
Duku	Duku	Duku
dukung	dukung	dukung
dukungan	dukung an	dukung
Dulu	Dulu	Dulu
Dunia	Dunia	Dunia
Duren	Duren	Duren
Dusun	Dusun	Dusun
Duta	Duta	Duta
duyun	duyun	duyun
edukasi	edukasi	edukasi
efek	efek	efek
efektif	efektif	efektif
Ekologis	Ekologis	Ekologis
ekonomi	ekonomi	ekonomi
eksklusif	eksklusif	eksklusif
ekspedisi	ekspedisi	ekspedisi
eksplorasi	eksplorasi	eksplorasi
eksponensial	eksponensial	eksponensial
Ekspres	Ekspres	Ekspres
eksternal	eksternal	eksternal
ekstrem	ekstrem	ekstrem
emang	emang	emang
embusan	embus an	embus
empat	empat	empat
Energi	Energi	Energi
energinya	energi nya	energi
Enggak	Enggak	Enggak
epidemi	epidemi	epidemi
episenter	episenter	episenter
erat	erat	erat
erosi	erosi	erosi
Erupsi	Erupsi	Erupsi
es	es	es
esok	esok	esok
estimasi	estimasi	estimasi
evakuasi	evakuasi	evakuasi
fakta	fakta	fakta
faktor-faktor	faktor - faktor	faktor
fakultas	fakultas	fakultas
fasilitas	fasilitas	fasilitas
fasilitasinya	fasilitasi nya	fasilitasi
Februari	Februari	Februari
fenomena	fenomena	fenomena
fenomenal	fenomenal	fenomenal
final	final	final
fiskal	fiskal	fiskal
flu	flu	flu
Fokus	Fokus	Fokus
Forum	Forum	Forum
Foto	Foto	Foto
foto-foto	foto - foto	foto
fotografer	fotografer	fotografer
Fotonya	Foto nya	Foto
gabungan	gabung an	gabung
Gagal	Gagal	Gagal
galon	galon	galon
gambar	gambar	gambar
gambut	gambut	gambut
Ganteng	Ganteng	Ganteng
gedung	gedung	gedung
gedung-gedung	gedung - gedung	gedung
Gejala	Gejala	Gejala
gejala-gejala	gejala - gejala	gejala
gejalanya	gejala nya	gejala
Gelombang	Gelombang	Gelombang
gelombangnya	gelombang nya	gelombang
Gempa	Gempa	Gempa
gempanya	gempa nya	gempa
genap	genap	genap
Geofisika	Geofisika	Geofisika
geografi	geografi	geografi
Geologi	Geologi	Geologi
Gerbang	Gerbang	Gerbang
gergaji	gergaji	gergaji
getah	getah	getah
getaran	getar an	getar
Getarkan	Getar kan	Getar
gigaton	gigaton	gigaton
Global	Global	Global
gorong-gorong	gorong - gorong	gorong
Got	Got	Got
gua	gua	gua
gulung	gulung	gulung
Gulungan	Gulung an	Gulung
guna	guna	guna
gundul	gundul	gundul
Guntur	Guntur	Guntur
Gunung	Gunung	Gunung
Gunungraja	Gunung raja	Gunung
gusi	gusi	gusi
Habib	Habib	Habib
habitat	habitat	habitat
hadir	hadir	hadir
hakikatnya	hakikat nya	hakikat
hal	hal	hal
hal-hal	hal - hal	hal
hambatan	hambat an	hambat
Hamil	Hamil	Hamil
hampir	hampir	hampir
Hantam	Hantam	Hantam
Hanya	Hanya	Hanya
hanyut	hanyut	hanyut
harap	harap	harap
Harapan	Harap an	Harap
harfiah	harfiah	harfiah
hari	hari	hari
hari-hari	hari - hari	hari
harinya	hari nya	hari
haruslah	harus lah	harus
hasilnya	hasil nya	hasil
hati	hati	hati
hebat	hebat	hebat
heboh	heboh	heboh
Hebohkan	Heboh kan	Heboh
helikopter	helikopter	helikopter
hidrologi	hidrologi	hidrologi
hilang	hilang	hilang
Hilir	Hilir	Hilir
hotel	hotel	hotel
hubungan	hubung an	hubung
hujan	hujan	hujan
hujannya	hujan nya	hujan
hukum	hukum	hukum
Hulu	Hulu	Hulu
huniannya	hunian nya	hunian
Hutan	Hutan	Hutan
IBADAH	IBADAH	IBADAH
ibarat	ibarat	ibarat
Ibu	Ibu	Ibu
ibunya	ibu nya	ibu
ijal	ijal	ijal
ikhlas	ikhlas	ikhlas
Iklan	Iklan	Iklan
Iklim	Iklim	Iklim
ikut	ikut	ikut
Ilir	Ilir	Ilir
ilmiah	ilmiah	ilmiah
Ilmu	Ilmu	Ilmu
ilmuwan	ilmu wan	ilmu
Ilustrasi	Ilustrasi	Ilustrasi
imbas	imbas	imbas
Imbau	Imbau	Imbau
impor	impor	impor
inap	inap	inap
indah	indah	indah
induk	induk	induk
infeksi	infeksi	infeksi
informasi	informasi	informasi
Ini	Ini	Ini
inilah	ini lah	ini
insektisida	insektisida	insektisida
instrumen	instrumen	instrumen
intensitas	intensitas	intensitas
intensitasnya	intensitas nya	intensitas
internal	internal	internal
Ironisnya	Ironis nya	Ironis
Istri	Istri	Istri
istrinya	istri nya	istri
Isu	Isu	Isu
Jalan	Jalan	Jalan
jamban	jamban	jamban
Jambu	Jambu	Jambu
jamnya	jam nya	jam
jangan	jangan	jangan
jangka	jangka	jangka
janji	janji	janji
jantung	jantung	jantung
januari	januari	januari
jaraknya	jarak nya	jarak
jasad	jasad	jasad
Jati	Jati	Jati
jatuh	jatuh	jatuh
jatuhnya	jatuh nya	jatuh
jauh	jauh	jauh
jauhnya	jauh nya	jauh
jawab	jawab	jawab
Jaya	Jaya	Jaya
jebol	jebol	jebol
jebolnya	jebol nya	jebol
jelek	jelek	jelek
Jembatan	Jembatan	Jembatan
jendela	jendela	jendela
Jenderal	Jenderal	Jenderal
jentik-jentiknya	jentik - jentik nya	jentik
jenuh	jenuh	jenuh
Jepang	Jepang	Jepang
jerami	jerami	jerami
Jerman	Jerman	Jerman
Jeruk	Jeruk	Jeruk
Jika	Jika	Jika
jilbab	jilbab	jilbab
Jiwa	Jiwa	Jiwa
judi	judi	judi
Juga	Juga	Juga
juli	juli	juli
Jumat	Jumat	Jumat
Jumlah	Jumlah	Jumlah
jumlahkan	jumlah kan	jumlah
jumlahnya	jumlah nya	jumlah
juni	juni	juni
jurnal	jurnal	jurnal
juru	juru	juru
Jurus	Jurus	Jurus
justru	justru	justru
juta	juta	juta
Kabar	Kabar	Kabar
Kabupaten	Kabupaten	Kabupaten
Kaca	Kaca	Kaca
kacir	kacir	kacir
kadang-kadang	kadang - kadang	kadang 
kalah	kalah	kalah
kalau	kalau	kalau
Kali	Kali	Kali
kalian	kalian	kalian
kami	kami	kami
Kamis	Kamis	Kamis
kampanye	kampanye	kampanye
kampung	kampung	kampung
kantong	kantong	kantong
kantong-kantong	kantong - kantong	kantong
kantung	kantung	kantung
kapal	kapal	kapal
kapal-kapal	kapal - kapal	kapal 
kapanpun	kapan pun	kapan
kaprah	kaprah	kaprah
kapten	kapten	kapten
Kapur	Kapur	Kapur
karakteristik	karakteristik	karakteristik
karang	karang	karang
Karawang	Karawang	Karawang
karbon	karbon	karbon
karena	karena	karena
Karet	Karet	Karet
karir	karir	karir
kartu	kartu	kartu
kasus	kasus	kasus
Kata	Kata	Kata
Kata-kata	Kata - kata	Kata 
katanya	kata nya	kata
kawah	kawah	kawah
kawahnya	kawah nya	kawah
Kawasan	Kawasan	Kawasan
kayu	kayu	kayu
keadaan	ke ada an	ada
Kebakaran	Ke bakar an	bakar
kebanyakan	ke banya kan	banya
kebawah	ke bawah	bawah
kebeberapa	ke be berapa	berapa
keberadaan	ke berada an	berada
Keberangkatan	Ke berangkat an	berangkat
kebetulan	ke betul an	betul
Kebon	Kebon	Kebon
Kebun	Kebun	Kebun
Kecamatan	Ke camat an	camat
Kecelakaan	Ke celaka an	celaka
kecepatan	ke cepat an	cepat
Kecil	Kecil	Kecil
Kecuali	Kecuali	Kecuali
kedalaman	ke dalam an	dalam
Kedatangan	Ke datang an	datang
kedepannya	ke depan nya	depan
kedinginan	ke dingin an	dingin
Keempat	Ke empat	empat
kegelapan	ke gelap an	gelap
kegiatan	ke giat an	giat
Kehadiran	Ke hadir an	hadir
kehancuran	ke hancur an	hancur
kehendak	ke hendak	hendak
kehutanan	ke hutan an	hutan
kejadian	ke jadi an	jadi
Kejar	Kejar	Kejar
kejayaan	ke jaya an	jaya
kekagetan	ke kaget an	kaget
kekebalan	ke kebal an	kebal
kekerasan	ke keras an	keras
kekuatan	ke kuat an	kuat
kekurangan	ke kurang an	kurang
Kelalaian	Ke lalai an	lalai
kelam	kelam	kelam
kelambu	ke lambu	lambu
KELAPANGAN	KE LAPANG AN	LAPANG
Kelaparan	Ke lapar an	lapar
kelenjar	kelenjar	kelenjar
keluar	ke luar	luar
keluarnya	keluar nya	keluar
Kelurahan	Ke lurah an	lurah
kemajuan	ke maju an	maju
Kemanusian	Ke manusi an	manusi
Kemarin	Kemarin	Kemarin
kematian	ke mati an	mati
kembali	kembali	kembali
Kembangan	Kembang an	Kembang
Kemiringan	Ke miring an	miring
Kemudian	Ke mudi an	mudi
kemungkinan	ke mungkin an	mungkin
Kenaikan	Ke naik an	naik
Kenal	Kenal	Kenal
kenapa	kenapa	kenapa
kendala	kendala	kendala
kenyataan	ke nyata an	nyata
Kepada	Kepada	Kepada
kepala	kepala	kepala
Kepanikan	Ke panik an	panik
kepemilikan	ke pe milik an	milik
kepentingan	ke penting an	penting
kepercayaan	ke percaya an	percaya
Kepolisian	Ke polisi an	polisi
kepulan	kepul an	kepul
kepulauan	ke pulau an	pulau
Kepungan	Kepung an	Kepung
keputusannya	ke putus an nya	putus
kera	kera	kera
kerajinan	ke rajin an	rajin
kerap	kerap	kerap
kerja	kerja	kerja
kerusuhan	ke rusuh an	rusuh
kesalahan	ke salah an	salah
kesana	ke sana	sana
Kesebelas	Ke sebelas	sebelas
keselamatannya	ke selamat an nya	selamat
keseluruh	ke seluruh	seluruh
kesempatan	ke sempat an	sempat
kesepakatan	ke sepakat an	sepakat
kesepuluh	ke sepuluh	sepuluh
Kesimpangsiuran	Ke simpang siur an	simpang
Kesimpulannya	Ke simpul an nya	simpul
kesulitan	ke sulit an	sulit
kesusahan	ke susah an	susah
ketakutan	ke takut an	takut
ketenangan	ke tenang an	tenang
keterangan	ke terang an	terang
keterkaitan	ke ter kait an	kait
Ketiadaan	Ke tiada an	tiada
ketidak	ke tidak	tidak
ketidakseriusan	ke tidak serius an	serius
Ketika	Ke tika	tika
Ketimbang	Ke timbang	timbang
Ketua	Ke tua	tua
ketujuh	ke tujuh	tujuh
kewalahan	ke walah an	walah
khusyuk	khusyuk	khusyuk
Kidul	Kidul	Kidul
kilometer	kilometer	kilometer
kimia	kimia	kimia
kini	kini	kini
kira-kira	kira - kira	kira
kisah	kisah	kisah
Kita	Kita	Kita
klakson	klakson	klakson
klimatologi	klimatologi	klimatologi
klinis	klinis	klinis
kocar	kocar	kocar
Kolam	Kolam	Kolam
Koleksi	Koleksi	Koleksi
kombinasi	kombinasi	kombinasi
komentar	komentar	komentar
Komite	Komite	Komite
kompleks	kompleks	kompleks
komprehensif	komprehensif	komprehensif
komunikasi	komunikasi	komunikasi
Kondisi	Kondisi	Kondisi
Kondisinya	Kondisi nya	Kondisi
konfigurasi	konfigurasi	konfigurasi
Konflik	Konflik	Konflik
konsesi	konsesi	konsesi
konsetrasinya	konsetrasi nya	konsetrasi
konstruksi	konstruksi	konstruksi
koordinasi	koordinasi	koordinasi
Kota	Kota	Kota
Kota-kota	Kota - kota	kota
kotak	kotak	kotak
Krisis	Krisis	Krisis
kronis	kronis	kronis
Kronologis	Kronologis	Kronologis
kru	kru	kru
kuarsa	kuarsa	kuarsa
Kuat	Kuat	Kuat
Kuburan	Kubur an	Kubur
kue	kue	kue
Kulai	Kulai	Kulai
kuning	kuning	kuning
Kunjungannya	Kunjung an nya	Kunjung
kuno	kuno	kuno
Kupang	Kupang	Kupang
kurang	kurang	kurang
kurangi	kurang i	kurang
kurma	kurma	kurma
kurun	kurun	kurun
kutub	kutub	kutub
laba	laba	laba
Ladang	Ladang	Ladang
lain	lain	lain
lainnya	lain nya	lain
laju	laju	laju
laksana	laksana	laksana
Lakukan	Laku kan	Laku
Lalu	Lalu	Lalu
lama	lama	lama
lampu	lampu	lampu
Langganan	Langgan an	Langgan
langka	langka	langka
langkah	langkah	langkah
Langsung	Langsung	Langsung
lanjut	lanjut	lanjut
Lanjutkan	Lanjut kan	Lanjut
lantai	lantai	lantai
lapang	lapang	lapang
lapangan	lapang an	lapang
lapisan	lapis an	lapis
Laporan	Lapor an	Lapor
Laporannya	Laporan nya	Laporan
lapuknya	lapuk nya	lapuk
Larikan	Lari kan	Lari
Laut	Laut	Laut
lautan	laut an	laut
Lawang	Lawang	Lawang
layanan	layan an	layan
lebat	lebat	lebat
lebur	lebur	lebur
legislatif	legislatif	legislatif
lekas	lekas	lekas
lembaga	lembaga	lembaga
lempeng	lempeng	lempeng
Lenyap	Lenyap	Lenyap
lepas	lepas	lepas
lereng	lereng	lereng
lestari	lestari	lestari
letaknya	letak nya	letak
Letnan	Letnan	Letnan
letusan	letus an	letus
lewat	lewat	lewat
lihat	lihat	lihat
likuifikasi	likuifikasi	likuifikasi
Lima	Lima	Lima
Limapuluh	Lima puluh	Lima
limpasan	limpas an	limpas
lingkaran	lingkar an	lingkar
Lingkungan	Lingkung an	Lingkung
lipat	lipat	lipat
lisensi	lisensi	lisensi
literatur	literatur	literatur
logikanya	logika nya	logika
logistik	logistik	logistik
lokal	lokal	lokal
Lokasi	Lokasi	Lokasi
lokasi-lokasi	lokasi - lokasi	lokasi 
longsor	longsor	longsor
longsoran	longsor an	longsor
losion	losion	losion
Lubuk	Lubuk	Lubuk
luka	luka	luka
luka-luka	luka - luka	luka
Lumpur	Lumpur	Lumpur
lupa	lupa	lupa
lusa	lusa	lusa
lutut	lutut	lutut
maaf	maaf	maaf
macet	macet	macet
maghrib	maghrib	maghrib
magnitud	magnitud	magnitud
Maha	Maha	Maha
mahasiswa	maha siswa	siswa
maka	maka	maka
Makalah	Makalah	Makalah
MAKIN	MAKIN	MAKIN
malah	malah	malah
Malam	Malam	Malam
malaria	malaria	malaria
mampir	mampir	mampir
mampu	mampu	mampu
mandi	mandi	mandi
mandiri	mandiri	mandiri
Mangga	Mangga	Mangga
mantap	mantap	mantap
Manusia	Manusia	Manusia
Maret	Maret	Maret
Maritim	Maritim	Maritim
Markas	Markas	Markas
mas	mas	mas
Masa	Masa	Masa
Masalah	Masalah	Masalah
MASIH	MASIH	MASIH
masing-masing	masing - masing	masing
Masjid	Masjid	Masjid
masker	masker	masker
masyarakat	masyarakat	masyarakat
Mata	Mata	Mata
Matahari	Matahari	Matahari
Materi	Materi	Materi
materil	materil	materil
mati-matian	mati - mati an	mati
maupun	mau pun	mau
Mayat-mayat	Mayat - mayat	mayat
mayur	mayur	mayur
Mbak	Mbak	Mbak
medan	medan	medan
media-media	media - media	media
Medis	Medis	Medis
Meganya	Mega nya	Mega
megaton	megaton	megaton
mei	mei	mei
melacak	me lacak	lacak
melainkan	me lain kan	lain
melakukan	me laku kan	laku
melalui	me lalu i	lalu
melancarkan	me lancar kan	lancar
melanjutkan	me lanjut kan	lanjut
melapisi	me lapis i	lapis
melaporkan	me lapor kan	lapor
melawan	me lawan	lawan
Melayang	Me layang	layang
Melayat	Me layat	layat
Melayu	Melayu	Melayu
melebihi	me lebih i	lebih
Meledak	Me ledak	ledak
meleset	meleset	meleset
meletakkan	me letak kan	letak
meletusnya	me letus nya	letus
melihatnya	melihat nya	melihat
melintasi	me lintas i	lintas
meliputi	me liput i	liput
melisting	me listing	listing
Meluas	Me luas	luas
melukai	me luka i	luka
melumpuhkan	me lumpuh kan	lumpuh
meluncur	me luncur	luncur
Meluruh	Me luruh	luruh
memacu	me <m>acu	<m>acu
memadai	me <m>adai	<m>adai
memadamkan	me <m>adam kan	<m>adam
memadamkannya	me <m>adam kan nya	<m>adam
memadati	me <m>adat i	<m>adat
Memakai	Me <m>akai	<m>akai
memang	memang	memang
memanjang	me <m>anjang	<m>anjang
memantau	me <m>antau	<m>antau
Memasang	Me <m>asang	<m>asang
mematikan	me mati kan	mati
membakar	mem bakar	bakar
membalik	mem balik	balik
membangun	mem bangun	bangun
Membara	Mem bara	bara
membawa	mem bawa	bawa
membenahinya	mem benah i nya	benah
membendung	mem bendung	bendung
membentuk	mem bentuk	bentuk
memberi	mem beri	beri
memberikan	mem beri kan	beri
membuat	mem buat	buat
membuatnya	mem buat nya	buat
membudaya	mem budaya	budaya
Membujuk	Mem bujuk	bujuk
membuka	mem buka	buka
memburu	mem buru	buru
memburuk	mem buruk	buruk
membusuk	mem busuk	busuk
membutuh	mem butuh	butuh
membutuhkan	mem butuh kan	butuh
memecah	me <m>ecah	<m>ecah
memeluk	me <m>eluk	<m>eluk
memenuhi	me <m>enuh i	<m>enuh
memeriksa	me <m>eriksa	<m>eriksa
memetik	me <m>etik	<m>etik
memiliki	me milik i	milik
memilukan	me <m>ilu kan	<m>ilu
memimpin	me <m>impin	<m>impin
memindahkan	me <m>indah kan	<m>indah
memonitor	me monitor	monitor
memorakporandakan	me <m>orakporanda kan	<m>orakporanda
mempercepat	mem per cepat	cepat
memperhitungkan	mem per hitung kan	hitung
memperkuat	mem per kuat	kuat
memperlihatkan	mem per lihat kan	lihat
memperoleh	mem per oleh	oleh
mempidanakan	mem pidana kan	pidana
memprotes	mem protes	protes
memulai	me mulai	mulai
memuncratkan	me muncrat kan	muncrat
memunculkan	me muncul kan	muncul
memungkinkan	me mungkin kan	mungkin
memuntahkan	me muntah kan	muntah
memutuskan	me <m>utus kan	<m>utus
menaburkan	me <n>abur kan	<n>abur
menacapi	me <n>acap i	<n>acap
menahan	me <n>ahan	<n>ahan
menambahkan	me <n>ambah kan	<n>ambah
menampung	me <n>ampung	<n>ampung
menampungnya	me <n>ampung nya	<n>ampung
menandai	me <n>anda i	<n>anda
menang	menang	menang
menangani	me <n>angan i	<n>angan
menanggapi	men anggap i	anggap
menantang	me <n>antang	<n>antang
menarik	me <n>arik	<n>arik
menayangkan	me <n>ayang kan	<n>ayang
mencairkannya	men cair kan nya	cair
mencapai	men capai	capai
mencatat	men catat	catat
mencegah	men cegah	cegah
mencemaskan	men cemas kan	cemas
menceritakan	men cerita kan	cerita
mencerminkan	men cermin kan	cermin
mencolok	men colok	colok
mendapat	men dapat	dapat
mendapatkan	men dapat kan	dapat
mendata	men data	data
mendekat	men dekat	dekat
mendekati	men dekat i	dekat
mendengar	men dengar	dengar
mendesak	men desak	desak
mendeteksi	men deteksi	deteksi
mendirikan	men diri kan	diri
mendistribusikan	men distribusi kan	distribusi
mendoakan	men doa kan	doa
Menemani	Me <n>eman i	<n>eman
menempatkan	me <n>empat kan	<n>empat
menemukan	me <n>emu kan	<n>emu
Menengah	Me <n>engah	<n>engah
Menentukan	Me <n>entu kan	<n>entu
menerbangkan	me <n>erbang kan	<n>erbang
menerjang	me <n>erjang	<n>erjang
menetap	me <n>etap	<n>etap
Menetapkan	Me <n>etap kan	<n>etap
mengaktifkan	meng aktif kan	aktif
mengakui	meng aku i	aku
mengalami	meng alam i	alam
mengalir	meng alir	alir
mengalirnya	meng alir nya	alir
mengalokasikan	meng alokasi kan	alokasi
mengambil	meng ambil	ambil
mengancam	meng ancam	ancam
mengandalkan	meng andal kan	andal
mengapa	mengapa	mengapa
mengarah	meng arah	arah
mengatasi	meng atas i	atas
mengatur	meng atur	atur
mengelilingi	men <g>eliling i	<g>eliling
mengeluarkan	men <g>eluar kan	<g>eluar
mengembangkan	men <g>embang kan	<g>embang
mengenai	mengenai	mengenai
mengenaskan	me ngenas kan	ngenas
Mengering	Men <g>ering	<g>ering
mengetengahkan	me nge tengah kan	tengah
mengetes	meng etes	etes
mengevakuasi	meng evakuasi	evakuasi
menggambarkan	meng gambar kan	gambar
menggapai	meng gapai	gapai
menggarap	meng garap	garap
menggelontorkan	meng gelontor kan	gelontor
menggerakkan	meng gerak kan	gerak
menggerus	meng gerus	gerus
menggunakan	meng guna kan	guna
mengguncang	meng guncang	guncang
menggusur	meng gusur	gusur
menghalangi	meng halang i	halang
menghambat	meng hambat	hambat
menghantam	meng hantam	hantam
menghanyutkan	meng hanyut kan	hanyut
mengharubirukan	meng harubiru kan	harubiru
menghasilkan	meng hasil kan	hasil
menghilang	meng hilang	hilang
menghilangkan	meng hilang kan	hilang
menghimbau	meng himbau	himbau
menghutankan	meng hutan kan	hutan
mengikuti	meng ikut i	ikut
mengindikasikan	meng indikasi kan	indikasi
menginginkan	meng ingin kan	ingin
menginvestigasi	meng investigasi	investigasi
mengirimkan	men <g>irim kan	<g>irim
mengkoneksikan	meng koneksi kan	koneksi
mengontrol	men <g>ontrol	<g>ontrol
mengoptimalkan	meng optimal kan	optimal
mengubah	meng ubah	ubah
mengulas	meng ulas	ulas
mengumpulkan	meng umpul kan	umpul
mengumumkan	meng umum kan	umum
Mengundang	Meng undang	undang
Mengungsi	Meng ungsi	ungsi
mengunjungi	men <g>unjung i	<g>unjung
menguntungkan	meng untung kan	untung
mengurangi	men <g>urang i	<g>urang
mengutamakan	meng utama kan	utama
mengutip	men <g>utip	<g>utip
menikmati	me nikmat i	nikmat
menilai	me nilai	nilai
menimbun	me <n>imbun	<n>imbun
meninggalkan	me <n>inggal kan	<n>inggal
meninggi	me <n>inggi	<n>inggi
Meningkat	Me <n>ingkat	<n>ingkat
meningkatkan	me <n>ingkat kan	<n>ingkat
meningkatnya	me <n>ingkat nya	<n>ingkat
meninjau	me <n>injau	<n>injau
menit	menit	menit
menjadi	men jadi	jadi
menjaganya	men jaga nya	jaga
menjalani	men jalan i	jalan
menjalar	men jalar	jalar
menjauh	men jauh	jauh
menjelang	men jelang	jelang
menjelaskan	men jelas kan	jelas
menolaknya	me <n>olak nya	<n>olak
menolong	me <n>olong	<n>olong
menontonnya	me <n>onton nya	<n>onton
mensterilkan	men steril kan	steril
Menteri	Menteri	Menteri
menuju	me <n>uju	<n>uju
menular	me <n>ular	<n>ular
menumbangkan	me <n>umbang kan	<n>umbang
menumpahkan	me <n>umpah kan	<n>umpah
menumpuk	me <n>umpuk	<n>umpuk
menunaikan	me <n>unai kan	<n>unai
menunggu	me <n>unggu	<n>unggu
menunjukkan	me <n>unjuk kan	<n>unjuk
menuntut	me <n>untut	<n>untut
menurun	me <n>urun	<n>urun
menuruni	me <n>urun i	<n>urun
menurunkan	me <n>urun kan	<n>urun
menurut	me <n>urut	<n>urut
Menurutnya	Me <n>urut nya	<n>urut
Menutup	Me <n>utup	<n>utup
menuturkan	me <n>uturk an	<n>uturk
menyajikan	men <y>aji kan	<y>aji
menyaksikan	men <y>aksi kan	<y>aksi
menyalahkan	men <y>alah kan	<y>alah
menyambut	men <y>ambut	<y>ambut
menyampaikan	men <y>ampai kan	<y>ampai
menyangkut	men <y>angkut	<y>angkut
menyatu	men <y>atu	<y>atu
menyebalkan	men <y>ebal kan	<y>ebal
menyebar	men <y>ebar	<y>ebar
menyediakan	men <y>edia kan	<y>edia
menyelamatkan	men <y>elamat kan	<y>elamat
menyelesaikan	men <y>elesai kan	<y>elesai
menyeluruh	men <y>eluruh	<y>eluruh
menyempit	men <y>empit	<y>empit
menyemprotkan	men <y>emprot kan	<y>emprot
menyentuh	men <y>entuh	<y>entuh
Menyeramkan	Men <y>eram kan	<y>eram
menyerap	men <y>erap	<y>erap
menyerbu	men <y>erbu	<y>erbu
menyeret	men <y>eret	<y>eret
menyimpan	men <y>impan	<y>impan
menyulitkan	men <y>ulit kan	<y>ulit
menyumbat	men <y>umbat	<y>umbat
menyusul	men <y>usul	<y>usul
merah	merah	merah
merasakan	me rasa kan	rasa
Merata	Me rata	rata
mereda	me reda	reda
mereka	mereka	mereka
merekam	me rekam	rekam
merenggut	me renggut	renggut
merenung	me renung	renung
meresapkan	me resap kan	resap
merespon	me respon	respon
meretakkan	me retak kan	retak
merta	merta	merta
merupakan	me rupa kan	rupa
merusak	me rusak	rusak
mesin	mesin	mesin
Meski	Meski	Meski
meskipun	meski pun	meski
meteorologi	meteorologi	meteorologi
meter	meter	meter
miliar	miliar	miliar
milik	milik	milik
mineral	mineral	mineral
minggu	minggu	minggu
minim	minim	minim
Minimal	Minimal	Minimal
Minyak	Minyak	Minyak
misalnya	misal nya	misal
misi	misi	misi
misi-misi	misi - misi	misi
Misteri	Misteri	Misteri
mobil	mobil	mobil
mobilnya	mobil nya	mobil
mobilpun	mobil pun	mobil
MODIS	MODIS	MODIS
Mogok	Mogok	Mogok
monumennya	monumen nya	monumen
morfologi	morfologi	morfologi
Muara	Muara	Muara
muda	muda	muda
mudahan	mudah an	mudah
Mulai	Mulai	Mulai
multi	multi	multi
multinasional	multinasional	multinasional
muncul	muncul	muncul
mungkin	mungkin	mungkin
muntahan	muntah an	muntah
musibah	musibah	musibah
naas	naas	naas
Naga	Naga	Naga
Nama	Nama	Nama
namanya	nama nya	nama
namun	namun	namun
Nantinya	Nanti nya	Nanti
napas	napas	napas
nasehati	nasehat i	nasehat
nasib	nasib	nasib
nasional	nasional	nasional
negara	negara	negara
negatif	negatif	negatif
negeri	negeri	negeri
Negosiasi	Negosiasi	Negosiasi
Neraka	Neraka	Neraka
ngotot	ngotot	ngotot
niat	niat	niat
nilai	nilai	nilai
nomor	nomor	nomor
normal	normal	normal
normalisasi	normalisasi	normalisasi
nuklir	nuklir	nuklir
Nusa	Nusa	Nusa
nyamuk	nyamuk	nyamuk
Nyamuknya	Nyamuk nya	Nyamuk
nyaris	nyaris	nyaris
nyawa	nyawa	nyawa
nyeri	nyeri	nyeri
obat	obat	obat
obat-obatan	obat - obat an	obat
observasi	observasi	observasi
obyek	obyek	obyek
Oktober	Oktober	Oktober
Oleh	Oleh	Oleh
ombak	ombak	ombak
Opak	Opak	Opak
operasi	operasi	operasi
Orang	Orang	Orang
orangtuanya	orang tua nya	orang tua
Organisasi	Organisasi	Organisasi
otonomi	otonomi	otonomi
Pabrik	Pabrik	Pabrik
Pada	Pada	Pada
Padahal	Padahal	Padahal
padat	padat	padat
Pagi	Pagi	Pagi
paham	paham	paham
pahit	pahit	pahit
pakai	pakai	pakai
pakaian	pakai an	pakai
pakar	pakar	pakar
Palem	Palem	Palem
Paling	Paling	Paling
panas	panas	panas
Panci	Panci	Panci
pancing	pancing	pancing
pandemi	pandemi	pandemi
Pangan	Pangan	Pangan
panggilan	panggil an	panggil
Pangkalan	Pangkal an	Pangkal
panik	panik	panik
Panjang	Panjang	Panjang
pantai	pantai	pantai
Pantau	Pantau	Pantau
Para	Para	Para
parah	parah	parah
parahnya	parah nya	parah
parkir	parkir	parkir
partisipatoris	partisipatoris	partisipatoris
Pasalnya	Pasal nya	Pasal
pasar	pasar	pasar
pasca	pasca	pasca
Pasir	Pasir	Pasir
Pasirjambu	Pasir jambu	Pasir jambu
pasokan	pasok an	pasok
Pasti	Pasti	Pasti
Pastikan	Pasti kan	Pasti
patah	patah	patah
patahan	patah an	patah
pauk	pauk	pauk
pecah	pecah	pecah
pegal	pegal	pegal
Pegunungan	Pe gunung an	gunung
pejuang	pe juang	juang
pekan	pekan	pekan
pekatnya	pekat nya	pekat
pekerja	pe kerja	kerja
Pekerjaan	Pe kerja an	kerja
Pelajaran	Pe <l>ajar an	<l>ajar
Pelajaran-pelajaran	Pe <l>ajar an - pe <l>ajar an	<l>ajar
Pelantikan	Pe lantik an	lantik
Pelaporan	Pe lapor an	lapor
pelebaran	pe lebar an	lebar
peluang	pe luang	luang
pelukannya	peluk an nya	peluk
pemadam	pe <m>adam	<m>adam
pemadaman	pe <m>adam an	<m>adam
pemangku	pe <m>angku	<m>angku
pemantauan	pe <m>antau an	<m>antau
pembaca	pem baca	baca
Pembahasan	Pem bahas an	bahas
Pembakar	Pem bakar	bakar
pembalakan	pem balak an	balak
Pembangunan	Pem bangun an	bangun
pembasmi	pem basmi	basmi
pembendungan	pem bendung an	bendung
pemberdayaan	pem berdaya an	berdaya
pemberitaan	pem berita an	berita
pembicaraan	pem bicara an	bicara
pembuktian	pem bukti an	bukti
pembunuh	pem bunuh	bunuh
pembunuhan	pem bunuh an	bunuh
pemeriksaan	pe <m>eriksa an	<m>eriksa
pemetaan	pe <m>eta an	<m>eta
pemetik	pe <m>etik	<m>etik
pemiliknya	pe milik nya	milik
Pemilu	Pemilu	Pemilu
pemindahan	pe <m>indah an	<m>indah
Pemukiman	Pe mukim an	mukim
Penajam	Pe <n>ajam	<n>ajam
penambahan	pe <n>ambah an	<n>ambah
penambangan	pe <n>ambang an	<n>ambang
penampung	pe <n>ampung	<n>ampung
Penanggulangan	Pe <n>anggul a ngan	<n>anggul 
penangkapan	pe <n>angkap an	<n>angkap
penasihat	pe nasihat	nasihat
Pencarian	Pen cari an	cari
Pendahuluan	Pen dahulu an	dahulu
pendataan	pen data an	data
pendek	pendek	pendek
pendeknya	pendek nya	pendek
pendidikan	pen didik an	didik
pendistribusian	pen distribusi an	distribusi
Penduduk	Pen duduk	duduk
penduduknya	pen duduk nya	duduk
pendukungnya	pen dukung nya	dukung
peneliti	pe <n>eliti	<n>eliti
penelitian	pe <n>eliti an	<n>eliti
penelitiannya	pe <n>eliti an nya	<n>eliti
penerangan	pe <n>erang an	<n>erang
penetapan	pe <n>etap an	<n>etap
pengalaman	peng alam an	alam
pengamat	peng amat	amat
penganggaran	peng anggar an	anggar
pengarusutamaan	peng arus utama an	arus
Pengatur	Peng atur	atur
pengaturan	peng atur an	atur
pengedropan	pen gedrop an	gedrop
pengeluaran	pen <g>eluar an	<g>eluar
pengendalian	pen <g>endali an	<g>endali
pengerahan	pen <g>erah an	<g>erah
Pengertian	Pe ngerti an	ngerti
pengetahuan	peng etahu an	etahu
pengevakuasian	peng evakuasi an	evakuasi
Penggilingan	Peng giling an	giling
pengguna	peng guna	guna
penggunaan	peng guna an	guna
penggundulan	peng gundul an	gundul
penghematan	peng hemat an	hemat
penghujan	peng hujan	hujan
penghuninya	peng huni nya	huni
pengukur	peng ukur	ukur
Pengungsi	Peng ungsi	ungsi
pengungsian	peng ungsi an	ungsi
pengurangan	pen <g>urang an	<g>urang
Penjaringan	Pen jaring an	jaring
penjelasan	pen jelas an	jelas
penonton	pe <n>onton	<n>onton
penuh	penuh	penuh
penunjaman	pe <n>unjam an	<n>unjam
penyakit	penyakit	penyakit
Penyebab	Pen <y>ebab	<y>ebab
Penyebabnya	Pen <y>ebab nya	<y>ebab
penyelamatan	pen <y>elamat an	<y>elamat
penyerapan	pen <y>erap an	<y>erap
Penyumbang	Pen <y>umbang	<y>umbang
penyumbatan	pen <y>umbat an	<y>umbat
penyusunan	pen <y>usun an	<y>usun
peradaban	per adab an	adab
perahu	perahu	perahu
perairan	per air an	air
Perak	Perak	Perak
perasaan	pe rasa an	rasa
perawat	pe rawat	rawat
perbedaan	per beda an	beda
perbukitan	per bukit an	bukit
perdagangan	per dagang an	dagang
perdamaian	per damai an	damai
Perdana	Perdana	Perdana
perdebatan	per debat an	debat
pereda	pe reda	reda
perencanaan	pe rencana an	rencana
perhatian	per hati an	hati
peringatan	per ingat an	ingat
perioda	perioda	perioda
periode	periode	periode
periodik	periodik	periodik
perjalanan	per jalan an	jalan
perjalanannya	per jalan an nya	jalan
perkara	perkara	perkara
perkebunan	per kebun an	kebun
Perkembangan	Per kembang an	kembang
perkiraan	per kira an	kira
perkotaan	per kota an	kota
Perlahan	Per lahan	lahan
perlengakapan	per lengakap an	lengakap
Perlindungan	Per lindung an	lindung
Permai	Permai	Permai
permainan	per main an	main
permesinan	per mesin an	mesin
pernah	pernah	pernah
pernyataan	per nyata an	nyata
perpindahan	per pindah an	pindah
perputaran	per putar an	putar
pers	pers	pers
persediaan	per sedia an	sedia
persen	persen	persen
persentasenya	persen tase nya	persen
Perserikatan	Per serikat an	serikat
persiapan	per siap an	siap
persinggahan	per singgah an	singgah
persoalan	per soal an	soal
pertama	pertama	pertama
pertemuan	per temu an	temu
pertengahan	per tengah an	tengah
perubahan	per ubah an	ubah
Perumahan	Pe rumah an	rumah
perut	perut	perut
Perwakilan	Per wakil an	wakil
pesawat	pesawat	pesawat
Pesing	Pesing	Pesing
petani	petani	petani
petik	petik	petik
petinggi-petinggi	petinggi - petinggi	petinggi
petir	petir	petir
Petugas	Pe tugas	tugas
pihak	pihak	pihak
pihaknya	pihak nya	pihak
pilar	pilar	pilar
Pilihan	Pilih an	Pilih
pimpin	pimpin	pimpin
Pinang	Pinang	Pinang
pindah	pindah	pindah
pinggir	pinggir	pinggir
pinggiran	pinggir an	pinggir
pintu	pintu	pintu
plastik	plastik	plastik
pohon	pohon	pohon
Polisi	Polisi	Polisi
politik	politik	politik
politisasi	politisasi	politisasi
polutan	polut an	polut
pompa	pompa	pompa
pondasi	pondasi	pondasi
Pondok	Pondok	Pondok
populasi	populasi	populasi
porak-poranda	porak - poranda	porak - poranda
pos	pos	pos
posisi	posisi	posisi
potensi	potensi	potensi
potensialnya	potensial nya	potensial
Potret	Potret	Potret
pragmatis	pragmatis	pragmatis
prakiraan	pra kira an	kira
praktik	praktik	praktik
Pramugari	Pramugari	Pramugari
Prasarana	Pra sarana	sarana
pria	pria	pria
prihatin	prihatin	prihatin
Prioritas	Prioritas	Prioritas
produk	produk	produk
produksi	produksi	produksi
produsen	produsen	produsen
Program	Program	Program
proses	proses	proses
proyek	proyek	proyek
puas	puas	puas
publik	publik	publik
pula	pula	pula
Pulau	Pulau	Pulau
puluhan	puluh an	puluh
puncak	puncak	puncak
Purba	Purba	Purba
purnama	purnama	purnama
pusat	pusat	pusat
Puskesmas	Puskesmas	Puskesmas
putih	putih	putih
Putra	Putra	Putra
putri	putri	putri
putus	putus	putus
rabu	rabu	rabu
radiasi	radiasi	radiasi
radikal	radikal	radikal
radius	radius	radius
Raja	Raja	Raja
rakyat	rakyat	rakyat
ramai	ramai	ramai
rangka	rangka	rangka
rangkaian	rangkai an	rangkai
Ransel	Ransel	Ransel
rasa	rasa	rasa
rasakan	rasa kan	rasa
rata-rata	rata - rata	rata
ratus	ratus	ratus
Ratusan	Ratus an	Ratus
raya	raya	raya
Redaksi	Redaksi	Redaksi
Rekahan	Rekah an	Rekah
rekaman	rekam an	rekam
rekayasa	rekayasa	rekayasa
Reklamasi	Reklamasi	Reklamasi
Rekonstruksi	Re konstruksi	konstruksi
rekor	rekor	rekor
relatif	relatif	relatif
Relawan	Rela wan	Rela
relokasi	re lokasi	lokasi
rencana	rencana	rencana
Rencanakan	Rencana kan	Rencana
Rendam	Rendam	Rendam
rentan	rentan	rentan
rentang	rentang	rentang
Republik	Republik	Republik
Republika	Republika	Republika
Ribu	Ribu	Ribu
ribuan	ribu an	ribu
ribut	ribut	ribut
Rilis	Rilis	Rilis
rincian	rinci an	rinci
ringan	ringan	ringan
Riski	Riski	Riski
roboh	roboh	roboh
royong	royong	royong
Ruang	Ruang	Ruang
Ruas	Ruas	Ruas
rubuh	rubuh	rubuh
rumah	rumah	rumah
runtuh	runtuh	runtuh
runtuhnya	runtuh nya	runtuh
rupanya	rupa nya	rupa
rupiah	rupiah	rupiah
rusaknya	rusak nya	rusak
rute	rute	rute
Sabtu	Sabtu	Sabtu
saja	saja	saja
Saking	Saking	Saking
Sakti	Sakti	Sakti
salah	salah	salah
salahsatunya	salah satu nya	satu
Salam	Salam	Salam
salat	salat	salat
salju	salju	salju
saluran	salur an	salur
Salurkan	Salur kan	Salur
sama-sama	sama - sama	sama
sambungan	sambung an	sambung
Sampai	Sampai	Sampai
sampel	sampel	sampel
samping	samping	samping
Samudera	Samudera	Samudera
Samudra	Samudra	Samudra
sandang	sandang	sandang
Sangat	Sangat	Sangat
sangatlah	sangat lah	sangat
Santunan	Santun an	Santun
sarang	sarang	sarang
Satelit	Satelit	Satelit
satu-satunya	satu - satu nya	satu
sawit	sawit	sawit
Saya	Saya	Saya
SAYANG	SAYANG	SAYANG
sayangnya	sayang nya	sayang
sayatan	sayatan	sayatan
sayur	sayur	sayur
Sebabnya	Sebab nya	Sebab
sebagai	se bagai	bagai
sebagaimana	se bagai mana	bagai
sebagian	se bagi an	bagi
sebaliknya	se balik nya	balik
sebanyak	se banyak	banyak
Sebaran	Sebar an	Sebar
Sebarkan	Sebar kan	Sebar
sebatas	se batas	batas
sebelahnya	se belah nya	belah
sebelum	se belum	belum
sebelumnya	se belum nya	belum
sebenarnya	se benar nya	benar
seberat	se berat	berat
Sebuah	Se buah	buah
sebutkan	sebut kan	sebut
Secara	Se cara	cara
Sedang	Sedang	Sedang
Sedangkan	Sedang kan	Sedang
sedemikian	se demikian	demikian
sedih	sedih	sedih
sedikit	sedikit	sedikit
sedikitnya	sedikit nya	sedikit
segelintir	se gelintir	gelintir
Segera	Segera	Segera
segitu	segitu	segitu
Segmen	Segmen	Segmen
sehari-hari	se hari - hari	hari
seharian	se hari an	hari
seharusnya	se harus nya	harus
sejak	sejak	sejak
sejarah	sejarah	sejarah
Sejumlah	Se jumlah	jumlah
Sejurus	Se jurus	jurus
sekaligus	se kali gus	kali
sekalipun	sekali pun	sekali
sekarang	sekarang	sekarang
seketika	se ketika	ketika
Sekitar	Sekitar	Sekitar
sekolah	sekolah	sekolah
sekretaris	sekretaris	sekretaris
selagi	se lagi	lagi
Selain	Se lain	lain
Selama	Se lama	lama
selamat	selamat	selamat
Selandia	Selandia	Selandia
Selanjutnya	Se lanjut nya	lanjut
Selat	Selat	Selat
Selatan	Selatan	Selatan 
selatan-tengah	selatan - tengah	selatan - tengah
selayaknya	se layak nya	layak
selesai	selesai	selesai
semacam	se macam	macam
semakin	se makin	makin
semalam	se malam	malam
sembari	sembari	sembari
sembilan	sembilan	sembilan
sementara	sementara	sementara
Seminari	Seminari	Seminari
seminggu	se minggu	minggu
Semisal	Se misal	misal
semoga	se moga	moga
Sempat	Sempat	Sempat
Sempet	Sempet	Sempet
sempurna	sempurna	sempurna
semua	semua	semua
semula	se mula	mula
senada	se nada	nada
sendiri	sen diri	diri
sendiri-sendiri	sen diri - sen diri	diri
senilai	se nilai	nilai
Senin	Senin	Senin
senjata	senjata	senjata
seolah	se olah	olah
sepanjang	se panjang	panjang
sepekan	se pekan	pekan
seperempat	se per empat	empat
September	September	September
Sepuluh	Sepuluh	Sepuluh
Serampah	Se rampah	rampah
serangga	serangga	serangga
serangkaian	se rangkai an	rangkai
serapan	serap an	serap
seratus	se ratus	ratus
sergapan	sergap an	sergap
sering	sering	sering
serta	serta	serta
serta-merta	serta - merta	serta
serupa	se rupa	rupa
Sesaat	Se saat	saat
Sesar	Sesar	Sesar
sesuai	sesuai	sesuai
sesuatu	se suatu	suatu
setahun	se tahun	tahun
setara	setara	setara
setelah	setelah	setelah
setelahnya	se telah nya	telah
setempat	se tempat	tempat
setengah	se tengah	tengah
setinggi	se tinggi	tinggi
seusai	se usai	usai
sholat	sholat	sholat
sia-sia	sia - sia	sia
Siaga	Siaga	Siaga
siap	siap	siap
sibuk	sibuk	sibuk
sifatnya	sifat nya	sifat
siklus	siklus	siklus
silahkan	silahkan	silahkan
silam	silam	silam
simak	simak	simak
sinergi	sinergi	sinergi
singkat	singkat	singkat
Sinyal	Sinyal	Sinyal
sirine	sirine	sirine
sisa-sisa	sisa - sisa	sisa
sisi	sisi	sisi
sistematis	sistematis	sistematis
Siswa	Siswa	Siswa
Situs	Situs	Situs
skenario	skenario	skenario
Soalnya	Soal nya	Soal
Solusi	Solusi	Solusi
sore	sore	sore
sorotan	sorot an	sorot
sosial	sosial	sosial
spesifik	spesifik	spesifik
stabil	stabil	stabil
staf	staf	staf
stasiun	stasiun	stasiun
status	status	status
Statusnya	Status nya	Status
strategis	strategis	strategis
Struktur	Struktur	Struktur
suaka	suaka	suaka
Suara	Suara	Suara
suatu	suatu	suatu
Subuh	Subuh	Subuh
Suci	Suci	Suci
Sudah	Sudah	Sudah
sukses	sukses	sukses
sulit	sulit	sulit
sumber	sumber	sumber
sumber-sumber	sumber - sumber	sumber
sumur	sumur	sumur
Sungai	Sungai	Sungai
supaya	supaya	supaya
Surut	Surut	Surut
survei	survei	survei
Survey	Survey	Survey
susah	susah	susah
susun	susun	susun
swadaya	swadaya	swadaya
syaraf	syaraf	syaraf
syarat	syarat	syarat
tabah	tabah	tabah
tadi	tadi	tadi
tahan	tahan	tahan
tahap	tahap	tahap
Tahu	Tahu	Tahu
tahunan	tahun an	tahun
tak	tak	tak
takdir	takdir	takdir
takut	takut	takut
tamah	tamah	tamah
Taman	Taman	Taman
tambah	tambah	tambah
tambahan	tambah an	tambah
Tambang	Tambang	Tambang
tanah	tanah	tanah
tanaman	tanam an	tanam
tanda-tanda	tanda - tanda	tanda
Tangan	Tangan	Tangan
tanggap	tanggap	tanggap
tangguh	tangguh	tangguh
Tanggul	Tanggul	Tanggul
tangker	tangker	tangker
tanjung	tanjung	tanjung
Tanpa	Tanpa	Tanpa
Tantangannya	Tantang an nya	Tantang
Tapi	Tapi	Tapi
target	target	target
tatkala	tat kala	kala
tebalnya	tebal nya	tebal
teh	teh	teh
tekanan	tekan an	tekan
teknisi	teknisi	teknisi
tektonik	tektonik	tektonik
tekukan-tekukan	tekuk an - tekuk an	tekuk
telat	telat	telat
telepon	telepon	telepon
televisi	televisi	televisi
teluk	teluk	teluk
teman-teman	teman - teman	teman
Tembok-tembok	Tembok - tembok	tembok
Tempa	Tempa	Tempa
tempat	tempat	tempat
Tempo	Tempo	Tempo
temui	temu i	temu
Tenaga	Tenaga	Tenaga
tenda	tenda	tenda
tenda-tenda	tenda - tenda	tenda
tengah	tengah	tengah
Tenggara	Tenggara	Tenggara
tenggelam	tenggelam	tenggelam
Tentang	Tentang	Tentang
tentara	tentara	tentara
tentu	tentu	tentu
teori	teori	teori
tepat	tepat	tepat
tepi	tepi	tepi
terakhir	ter akhir	akhir
teraktif	ter aktif	aktif
terakumulasi	ter akumulasi	akumulasi
terang	terang	terang
Terasa	Te rasa	rasa
teratak	teratak	teratak
teratur	ter atur	atur
Terbaik	Ter baik	baik
terbakar	ter bakar	bakar
terbaru	ter baru	baru
terbatas	ter batas	batas
Terbawa	Ter bawa	bawa
terbebas	ter bebas	bebas
terbelah	ter belah	belah
terbentuknya	ter bentuk nya	bentuk
Terbesar	Ter besar	besar
Tercatat	Ter catat	catat
terdaftar	ter daftar	daftar
terdalam	ter dalam	dalam
terdampak	ter dampak	dampak
Terdapat	Ter dapat	dapat
terdegradasi	ter degradasi	degradasi
terdeteksi	ter deteksi	deteksi
terendam	te rendam	rendam
terendapkan	ter endap kan	endap
terengah-engah	ter engah - engah	engah
Tergenang	Ter genang	genang
tergolong	ter golong	golong
terhambat	ter hambat	hambat
terhitung	ter hitung	hitung
Terima	Terima	Terima
terjadi	ter jadi	jadi
terjadilah	ter jadi lah	jadi
terjadinya	ter jadi nya	jadi
terjaga	ter jaga	jaga
terjal	terjal	terjal
terkait	ter kait	kait
terkenal	ter kenal	kenal
terkontaminasi	ter kontaminasi	kontaminasi
Terkuat	Ter kuat	kuat
terkubur	ter kubur	kubur
terlalu	ter lalu	lalu
terlambat	ter lambat	lambat
Terlebih	Ter lebih	lebih
terlepas	ter lepas	lepas
termasuk	ter masuk	masuk
Terminal	Terminal	Terminal
ternak	ternak	ternak
ternyata	ter nyata	nyata
terompet	terompet	terompet
Terorisme	Terorisme	Terorisme
terpaksa	ter paksa	paksa
terpapar	ter papar	papar
terparah	ter parah	parah
terpencil	ter pencil	pencil
Terpilih	Ter pilih	pilih
terpukul	ter pukul	pukul
tersapu	ter sapu	sapu
tersebar	ter sebar	sebar
tersentuh	ter sentuh	sentuh
tersenyum	ter senyum	senyum
Tersibak	Ter sibak	sibak
tersimpannya	ter simpan nya	simpan
tersisa	ter sisa	sisa
tertandingi	ter tanding i	tanding
tertimbun	ter timbun	timbun
tertinggi	ter tinggi	tinggi
tertiup	ter tiup	tiup
tertular	ter tular	tular
terungkap	ter ungkap	ungkap
terus-menerus	terus - me <n>erus	terus
Terutama	Ter utama	utama
tetap	tetap	tetap
tetapi	te tapi	tapi
tetes	tetes	tetes
tewas	tewas	tewas
tiada	tiada	tiada
tiap	tiap	tiap
Tidak	Tidak	Tidak
tidur	tidur	tidur
tikar	tikar	tikar
timbul	timbul	timbul
Timpa	Timpa	Timpa
timur	timur	timur
timur-tengah	timur - tengah	timur - tengah
timur-timur	timur - timur	timur
tindakan	tindak an	tindak
tinggal	tinggal	tinggal
tinggi	tinggi	tinggi
Tingginya	Tinggi nya	Tinggi
tingkatkan	tingkat kan	tingkat
Tinjau	Tinjau	Tinjau
tipe	tipe	tipe
tipis	tipis	tipis
tirai	tirai	tirai
toko	toko	toko
tol	tol	tol
Tolong	Tolong	Tolong
ton	ton	ton
Topan	Topan	Topan
topik	topik	topik
tornado	tornado	tornado
Tornado-tornado	Tornado - tornado	tornado
Total	Total	Total
Tragis	Tragis	Tragis
Transmigrasi	Transmigrasi	Transmigrasi
trauma	trauma	trauma
Tri	Tri	Tri
Triliun	Triliun	Triliun
tropis	tropis	tropis
tua	tua	tua
tubuh	tubuh	tubuh
tugas	tugas	tugas
tuhan	tuhan	tuhan
tujuan	tuju an	tuju
tujuh	tujuh	tujuh
tulang	tulang	tulang
tulisan	tulis an	tulis
tulisan-tulisan	tulis an - tulis an	tulis
tumpah	tumpah	tumpah
Tumpahan	Tumpah an	Tumpah
tunawisma	tuna wisma	tuna wisma
turis	turis	turis
turun	turun	turun
tutur	tutur	tutur
Udara	Udara	Udara
ujar	ujar	ujar
ujungnya	ujung nya	ujung
ukuran	ukur an	ukur
umumnya	umum nya	umum
umur	umur	umur
Undang-Undang	Undang - Undang	Undang
Ungkap	Ungkap	Ungkap
ungkapnya	ungkap nya	ungkap
unit	unit	unit
Untuk	Untuk	Untuk
Untunglah	Untung lah	Untung
Upaya	Upaya	Upaya
Urus	Urus	Urus
urutan	urut an	urut
usaha	usaha	usaha
Usai	Usai	Usai
usia	usia	usia
usulkan	usul kan	usul
utama	utama	utama
utamanya	utama nya	utama
vaksin-vaksinnya	vaksin - vaksin nya	vaksin
van	van	van
vektor	vektor	vektor
verifikasi	verifikasi	verifikasi
vertikal	vertikal	vertikal
vetegasi	vetegasi	vetegasi
video	video	video
Viral	Viral	Viral
volume	volume	volume
vulkanik	vulkanik	vulkanik
wabah	wabah	wabah
wah	wah	wah
wajar	wajar	wajar
wakil	wakil	wakil
waktu	waktu	waktu
Walaupun	Walau pun	Walau
Wali	Wali	Wali
wanita	wanita	wanita
Warga	Warga	Warga
waspada	waspada	waspada
Waspadai	Waspada i	Waspada
wawancara	wawancara	wawancara
wayangnya	wayang nya	wayang
wilayah	wilayah	wilayah
wilayah-wilayah	wilayah - wilayah	wilayah
wisata	wisata	wisata
ya	ya	ya
yang	yang	yang
yangdiposisikan	yang di posisi kan	posisi
zaman	zaman	zaman
zona	zona	zona
